team,win_perc,field_goals,field_goal_attemps,field_goal_perc,three_pointers,three_point_attempts,three_point_perc,free_throw_perc,two_pointers,two_point_attempts,two_point_perc,wins,losses,free_throws,free_throw_attemps,offensive_rebounds,defensive_rebounds,total_rebounds,assists,turnovers,steals,blocks,blocks_against,personal_fouls,total_points,score_differential,season
Atlanta Hawks,0.341,2829,6529,0.433,419,1249,0.3354683746997598,0.776,2410,5280,0.4564393939393939,28,54,1534,1976,996,2507,3503,1648,1350,627,408,416,1826,7611,-381,2003-04
Boston Celtics,0.439,2843,6415,0.443,553,1599,0.3458411507191995,0.75,2290,4816,0.4754983388704319,36,46,1572,2095,851,2440,3291,1683,1332,770,331,408,1837,7811,-119,2003-04
Chicago Bulls,0.28,2798,6753,0.414,429,1256,0.34156050955414013,0.725,2369,5497,0.4309623430962343,23,59,1330,1834,1048,2519,3567,1793,1321,659,396,446,1911,7355,-521,2003-04
Cleveland Cavaliers,0.427,2922,6753,0.433,247,786,0.3142493638676845,0.753,2675,5967,0.4482989777107424,35,47,1528,2030,1118,2619,3737,1808,1216,585,537,434,1743,7619,-215,2003-04
Dallas Mavericks,0.634,3322,7230,0.459,507,1456,0.3482142857142857,0.796,2815,5774,0.48753030827848975,52,30,1475,1854,1174,2538,3712,1963,1000,656,437,382,1609,8626,364,2003-04
Denver Nuggets,0.524,2993,6763,0.443,331,985,0.33604060913705586,0.767,2662,5778,0.4607130494980962,43,39,1655,2159,1083,2387,3470,1794,1278,745,520,479,1804,7972,88,2003-04
Detroit Pistons,0.659,2747,6314,0.435,333,968,0.3440082644628099,0.753,2414,5346,0.4515525626636738,54,28,1561,2074,1014,2492,3506,1702,1241,659,570,410,1664,7388,479,2003-04
Golden State Warriors,0.451,2875,6511,0.442,429,1283,0.3343725643024162,0.725,2446,5228,0.4678653404743688,37,45,1470,2028,1002,2533,3535,1681,1211,576,389,418,1691,7649,-60,2003-04
Houston Rockets,0.549,2738,6195,0.442,515,1406,0.3662873399715505,0.773,2223,4789,0.4641887659219044,45,37,1371,1774,847,2647,3494,1579,1373,560,443,359,1762,7362,142,2003-04
Indiana Pacers,0.744,2753,6322,0.435,449,1281,0.3505074160811866,0.764,2304,5041,0.45705217218805794,61,21,1538,2014,965,2452,3417,1774,1182,726,411,512,1709,7493,472,2003-04
Los Angeles Clippers,0.341,2817,6579,0.428,329,1024,0.3212890625,0.785,2488,5555,0.4478847884788479,28,54,1808,2302,1149,2416,3565,1653,1344,594,376,437,1816,7771,-376,2003-04
Los Angeles Lakers,0.683,3028,6676,0.454,365,1115,0.3273542600896861,0.693,2663,5561,0.4788707067074267,56,26,1631,2352,1001,2535,3536,1948,1132,682,379,308,1732,8052,320,2003-04
Memphis Grizzlies,0.61,2963,6657,0.445,447,1314,0.3401826484018265,0.727,2516,5343,0.47089650009358036,50,32,1557,2143,1047,2381,3428,1915,1226,795,565,461,1903,7930,200,2003-04
Miami Heat,0.512,2729,6417,0.425,485,1357,0.3574060427413412,0.762,2244,5060,0.4434782608695652,42,40,1459,1915,940,2459,3399,1565,1137,590,313,439,1812,7402,43,2003-04
Milwaukee Bucks,0.5,2970,6650,0.447,401,1145,0.3502183406113537,0.775,2569,5505,0.4666666666666667,41,41,1698,2192,960,2502,3462,1872,1110,554,383,406,1668,8039,87,2003-04
Minnesota Timberwolves,0.707,3033,6571,0.462,326,897,0.3634336677814939,0.781,2707,5674,0.47708847373986607,58,24,1361,1743,875,2645,3520,1890,1043,561,462,296,1731,7753,450,2003-04
New Jersey Nets,0.573,2813,6372,0.441,377,1123,0.3357079252003562,0.753,2436,5249,0.46408839779005523,47,35,1398,1856,862,2473,3335,2009,1209,709,322,374,1722,7401,205,2003-04
New Orleans Hornets,0.5,2772,6605,0.42,531,1666,0.3187274909963986,0.751,2241,4939,0.4537355740028346,41,41,1454,1937,1091,2418,3509,1716,1228,708,346,429,1715,7529,-11,2003-04
New York Knicks,0.476,2881,6513,0.442,406,1115,0.36412556053811657,0.793,2475,5398,0.45850314931456093,39,43,1374,1732,950,2543,3493,1695,1289,608,391,383,1897,7542,-121,2003-04
Orlando Magic,0.256,2904,6768,0.429,429,1248,0.34375,0.737,2475,5520,0.4483695652173913,21,61,1474,2000,1003,2350,3353,1584,1123,547,308,450,1744,7711,-576,2003-04
Philadelphia 76ers,0.402,2682,6260,0.428,339,992,0.34173387096774194,0.753,2343,5268,0.4447608200455581,33,49,1512,2009,941,2408,3349,1640,1307,654,358,463,1701,7215,-204,2003-04
Phoenix Suns,0.354,2958,6671,0.443,415,1202,0.3452579034941764,0.746,2543,5469,0.4649844578533553,29,53,1392,1865,924,2406,3330,1586,1249,734,383,431,1862,7723,-307,2003-04
Portland Trail Blazers,0.5,2898,6467,0.448,381,1102,0.3457350272232305,0.731,2517,5365,0.46915191053122085,41,41,1263,1728,1040,2376,3416,1768,1213,613,443,390,1554,7440,-104,2003-04
Sacramento Kings,0.671,3103,6711,0.462,601,1498,0.40120160213618156,0.795,2502,5213,0.4799539612507194,55,27,1626,2044,888,2492,3380,2152,1137,710,325,413,1586,8433,411,2003-04
San Antonio Spurs,0.695,2842,6434,0.442,408,1140,0.35789473684210527,0.681,2434,5294,0.45976577257272383,57,25,1409,2069,1029,2669,3698,1676,1203,661,537,380,1667,7501,592,2003-04
Seattle SuperSonics,0.451,2939,6590,0.446,723,1936,0.3734504132231405,0.765,2216,4654,0.4761495487752471,37,45,1363,1782,907,2318,3225,1782,1188,661,387,387,1784,7964,-52,2003-04
Toronto Raptors,0.402,2654,6348,0.418,461,1294,0.3562596599690881,0.75,2193,5054,0.43391373169766523,33,49,1237,1650,830,2419,3249,1574,1165,604,402,333,1748,7006,-247,2003-04
Utah Jazz,0.512,2690,6172,0.436,252,786,0.32061068702290074,0.746,2438,5386,0.45265503156331227,42,40,1639,2196,1103,2272,3375,1671,1365,581,494,530,2096,7271,-100,2003-04
Washington Wizards,0.305,2759,6557,0.421,434,1270,0.3417322834645669,0.714,2325,5287,0.43975789672782295,25,57,1579,2211,1115,2392,3507,1537,1439,733,406,448,1712,7531,-459,2003-04
Atlanta Hawks,0.159,2942,6672,0.441,304,973,0.31243576567317577,0.711,2638,5699,0.4628882260045622,13,69,1417,1994,1100,2335,3435,1614,1319,629,344,484,2009,7605,-796,2004-05
Boston Celtics,0.549,3046,6511,0.468,437,1252,0.3490415335463259,0.764,2609,5259,0.4961019205172086,45,37,1775,2323,909,2438,3347,1810,1297,667,423,402,2000,8304,71,2004-05
Charlotte Bobcats,0.22,2961,6859,0.432,320,881,0.36322360953461974,0.709,2641,5978,0.4417865506858481,18,64,1487,2096,1083,2335,3418,1794,1192,695,440,446,1894,7729,-491,2004-05
Chicago Bulls,0.573,2849,6592,0.432,511,1433,0.35659455687369157,0.75,2338,5159,0.4531886024423338,47,35,1536,2048,1001,2591,3592,1743,1371,576,369,434,2028,7745,87,2004-05
Cleveland Cavaliers,0.512,2990,6687,0.447,300,904,0.33185840707964603,0.752,2690,5783,0.46515649316963514,42,40,1634,2174,1117,2352,3469,1851,1141,654,461,419,1850,7914,65,2004-05
Dallas Mavericks,0.707,3058,6691,0.457,463,1273,0.36370777690494893,0.789,2595,5418,0.4789590254706534,58,24,1826,2314,990,2530,3520,1610,1102,708,461,399,1827,8405,471,2004-05
Denver Nuggets,0.598,3038,6615,0.459,320,940,0.3404255319148936,0.763,2718,5675,0.47894273127753306,49,33,1765,2313,967,2473,3440,1958,1224,750,489,458,1878,8161,166,2004-05
Detroit Pistons,0.659,2851,6421,0.444,363,1053,0.34472934472934474,0.739,2488,5368,0.46348733233979134,54,28,1588,2150,1054,2507,3561,1787,1133,576,497,367,1638,7653,317,2004-05
Golden State Warriors,0.415,3029,7039,0.43,624,1774,0.35174746335963925,0.722,2405,5265,0.4567901234567901,34,48,1412,1955,1069,2436,3505,1811,1112,642,420,417,1833,8094,-177,2004-05
Houston Rockets,0.622,2846,6419,0.443,553,1521,0.3635765943458251,0.781,2293,4898,0.46815026541445487,51,31,1551,1986,874,2601,3475,1733,1135,563,378,335,1807,7796,331,2004-05
Indiana Pacers,0.537,2668,6169,0.432,542,1575,0.3441269841269841,0.792,2126,4594,0.4627775359164127,44,38,1748,2206,868,2418,3286,1489,1173,615,357,398,1890,7626,62,2004-05
Los Angeles Clippers,0.451,2924,6368,0.459,231,669,0.3452914798206278,0.778,2693,5699,0.47253904193718194,37,45,1770,2274,980,2455,3435,1901,1290,599,422,393,1819,7849,-63,2004-05
Los Angeles Lakers,0.415,2895,6629,0.437,644,1813,0.3552123552123552,0.777,2251,4816,0.4674003322259136,34,48,1661,2137,1028,2511,3539,1672,1176,508,344,420,1794,8095,-243,2004-05
Memphis Grizzlies,0.549,2802,6271,0.447,531,1486,0.3573351278600269,0.754,2271,4785,0.4746081504702194,45,37,1526,2024,887,2307,3194,1716,1197,699,476,476,1910,7661,188,2004-05
Miami Heat,0.72,3097,6368,0.486,475,1260,0.376984126984127,0.672,2622,5108,0.5133124510571653,59,23,1658,2466,887,2639,3526,1791,1127,528,474,264,1814,8327,535,2004-05
Milwaukee Bucks,0.366,2964,6580,0.45,325,925,0.35135135135135137,0.772,2639,5655,0.4666666666666667,30,52,1720,2229,985,2405,3390,1720,1132,529,289,370,1797,7973,-245,2004-05
Minnesota Timberwolves,0.537,3045,6629,0.459,395,1145,0.34497816593886466,0.796,2650,5484,0.48322392414296134,44,38,1449,1820,947,2580,3527,1918,1079,460,447,323,1774,7934,119,2004-05
New Jersey Nets,0.512,2753,6419,0.429,435,1203,0.36159600997506236,0.763,2318,5216,0.44440184049079756,42,40,1555,2039,855,2387,3242,1772,1164,650,308,402,1985,7496,-123,2004-05
New Orleans Hornets,0.22,2718,6556,0.415,415,1316,0.31534954407294835,0.766,2303,5240,0.4395038167938931,18,64,1401,1830,1019,2281,3300,1724,1217,550,310,452,1883,7252,-580,2004-05
New York Knicks,0.402,2978,6599,0.451,441,1240,0.3556451612903226,0.767,2537,5359,0.47340921813771225,33,49,1580,2060,965,2393,3358,1665,1204,629,260,389,1942,7977,-200,2004-05
Orlando Magic,0.439,3034,6679,0.454,320,916,0.34934497816593885,0.759,2714,5763,0.4709352767655735,36,46,1772,2335,1038,2544,3582,1583,1322,633,441,354,1937,8160,-184,2004-05
Philadelphia 76ers,0.524,2946,6736,0.437,505,1453,0.3475567790777701,0.789,2441,5283,0.46204807874313836,43,39,1731,2194,909,2536,3445,1710,1274,756,321,383,1878,8128,-61,2004-05
Phoenix Suns,0.756,3351,7018,0.477,796,2026,0.3928923988153998,0.748,2555,4992,0.5118189102564102,62,20,1556,2080,967,2652,3619,1927,1125,572,453,342,1563,9054,584,2004-05
Portland Trail Blazers,0.329,2896,6422,0.451,420,1161,0.36175710594315247,0.725,2476,5261,0.4706329595134005,27,55,1409,1944,970,2404,3374,1722,1308,583,544,414,1703,7621,-328,2004-05
Sacramento Kings,0.61,3203,6978,0.459,522,1396,0.37392550143266473,0.787,2681,5582,0.48029380150483697,50,32,1577,2004,1023,2455,3478,2005,1073,674,316,365,1685,8505,177,2004-05
San Antonio Spurs,0.72,2923,6450,0.453,507,1395,0.3634408602150538,0.724,2416,5055,0.47794263105835805,59,23,1535,2120,987,2489,3476,1770,1126,613,543,421,1717,7888,640,2004-05
Seattle SuperSonics,0.634,2882,6498,0.444,666,1824,0.3651315789473684,0.79,2216,4674,0.47411210954214805,52,30,1683,2131,1041,2311,3352,1487,1113,553,338,390,1944,8113,188,2004-05
Toronto Raptors,0.402,2952,6656,0.444,648,1681,0.3854848304580607,0.774,2304,4975,0.46311557788944724,33,49,1626,2101,844,2444,3288,1670,1087,621,317,360,1876,8178,-133,2004-05
Utah Jazz,0.317,2828,6301,0.449,250,762,0.32808398950131235,0.757,2578,5539,0.4654269723776855,26,56,1719,2272,1047,2243,3290,1826,1292,541,374,474,2189,7625,-350,2004-05
Washington Wizards,0.549,2966,6794,0.437,514,1498,0.3431241655540721,0.725,2452,5296,0.46299093655589124,45,37,1795,2476,1133,2374,3507,1563,1172,716,347,412,1807,8241,-27,2004-05
Atlanta Hawks,0.317,2946,6496,0.454,424,1154,0.36741767764298094,0.75,2522,5342,0.47210782478472485,26,56,1656,2207,1069,2232,3301,1625,1284,587,394,422,2054,7972,-390,2005-06
Boston Celtics,0.402,2951,6322,0.467,467,1290,0.362015503875969,0.755,2484,5032,0.49364069952305245,33,49,1664,2204,813,2432,3245,1716,1359,578,422,404,2033,8033,-126,2005-06
Charlotte Bobcats,0.317,2961,6843,0.433,428,1261,0.3394131641554322,0.729,2533,5582,0.45378000716589034,26,56,1593,2186,990,2270,3260,1717,1167,822,354,441,1960,7943,-328,2005-06
Chicago Bulls,0.5,3004,6737,0.446,560,1477,0.3791469194312796,0.738,2444,5260,0.464638783269962,41,41,1452,1967,906,2602,3508,1804,1224,508,345,420,2038,8020,52,2005-06
Cleveland Cavaliers,0.61,2908,6412,0.454,497,1465,0.3392491467576792,0.729,2411,4947,0.48736608045279967,50,32,1689,2318,959,2511,3470,1560,1137,567,392,357,1733,8002,183,2005-06
Dallas Mavericks,0.732,2948,6375,0.462,416,1113,0.37376460017969454,0.783,2532,5262,0.4811858608893957,60,22,1818,2322,1030,2431,3461,1473,1112,593,488,400,1834,8130,498,2005-06
Denver Nuggets,0.537,3078,6672,0.461,350,1076,0.3252788104089219,0.744,2728,5596,0.4874910650464618,44,38,1721,2312,903,2486,3389,1921,1216,698,463,436,1863,8227,19,2005-06
Detroit Pistons,0.78,2983,6558,0.455,557,1451,0.3838731909028256,0.727,2426,5107,0.4750342666927746,64,18,1418,1950,975,2347,3322,1971,931,580,490,285,1513,7941,547,2005-06
Golden State Warriors,0.415,2939,6785,0.433,625,1832,0.3411572052401747,0.718,2314,4953,0.4671916010498688,34,48,1573,2190,980,2485,3465,1694,1156,604,356,409,1941,8076,-111,2005-06
Houston Rockets,0.415,2708,6252,0.433,469,1414,0.3316831683168317,0.759,2239,4838,0.4627945431996693,34,48,1502,1980,849,2565,3414,1580,1193,588,320,373,1863,7387,-130,2005-06
Indiana Pacers,0.5,2786,6274,0.444,536,1536,0.3489583333333333,0.737,2250,4738,0.4748839172646686,41,41,1591,2158,898,2559,3457,1631,1254,598,409,399,1821,7699,155,2005-06
Los Angeles Clippers,0.573,2993,6443,0.465,290,843,0.34400948991696323,0.791,2703,5600,0.4826785714285714,47,35,1694,2142,828,2704,3532,1708,1185,534,503,355,1872,7970,129,2005-06
Los Angeles Lakers,0.549,2992,6607,0.453,552,1583,0.3487049905243209,0.745,2440,5024,0.4856687898089172,45,37,1618,2172,970,2488,3458,1734,1143,628,350,354,1894,8154,205,2005-06
Memphis Grizzlies,0.598,2746,6125,0.448,590,1578,0.37389100126742714,0.711,2156,4547,0.4741587860127557,49,33,1476,2077,834,2379,3213,1586,1134,600,442,456,1757,7558,303,2005-06
Miami Heat,0.634,3039,6355,0.478,497,1441,0.34489937543372656,0.7,2542,4914,0.5172975172975173,52,30,1616,2310,858,2675,3533,1692,1186,522,442,298,1871,8191,317,2005-06
Milwaukee Bucks,0.488,2976,6566,0.453,507,1335,0.3797752808988764,0.738,2469,5231,0.4719938826228255,40,42,1561,2115,929,2448,3377,1769,1197,597,270,414,1902,8020,-85,2005-06
Minnesota Timberwolves,0.402,2888,6340,0.456,310,942,0.32908704883227174,0.758,2578,5398,0.4775842904779548,33,49,1436,1895,811,2422,3233,1716,1189,559,471,374,1889,7522,-154,2005-06
New Jersey Nets,0.598,2778,6317,0.44,477,1447,0.32964754664823775,0.758,2301,4870,0.4724845995893224,49,33,1658,2187,822,2539,3361,1884,1119,558,278,329,1903,7691,112,2005-06
New Orleans/Oklahoma City Hornets,0.463,2831,6428,0.44,300,885,0.3389830508474576,0.758,2531,5543,0.45661194299116004,38,44,1649,2176,918,2379,3297,1519,1095,611,311,432,1786,7611,-231,2005-06
New York Knicks,0.28,2822,6205,0.455,320,884,0.36199095022624433,0.726,2502,5321,0.4702123660965984,23,59,1878,2587,1033,2360,3393,1468,1449,555,271,436,2157,7842,-525,2005-06
Orlando Magic,0.439,2911,6167,0.472,299,796,0.3756281407035176,0.73,2612,5371,0.4863153975051201,36,46,1663,2277,892,2402,3294,1495,1240,532,362,386,1908,7784,-88,2005-06
Philadelphia 76ers,0.463,3001,6546,0.458,375,1031,0.36372453928225024,0.76,2626,5515,0.4761559383499547,38,44,1770,2330,873,2425,3298,1653,1159,651,404,386,1712,8147,-160,2005-06
Phoenix Suns,0.659,3430,7167,0.479,837,2097,0.39914163090128757,0.806,2593,5070,0.511439842209073,54,28,1189,1475,778,2650,3428,2179,1088,549,412,282,1683,8886,455,2005-06
Portland Trail Blazers,0.256,2791,6267,0.445,364,1042,0.3493282149712092,0.689,2427,5225,0.4644976076555024,21,61,1339,1944,886,2203,3089,1490,1205,529,435,403,1828,7285,-775,2005-06
Sacramento Kings,0.537,2954,6500,0.454,494,1408,0.3508522727272727,0.784,2460,5092,0.4831107619795758,44,38,1704,2173,852,2473,3325,1825,1199,608,299,403,1672,8106,126,2005-06
San Antonio Spurs,0.768,2993,6342,0.472,524,1362,0.38472834067547723,0.702,2469,4980,0.49578313253012046,63,19,1327,1891,851,2548,3399,1717,1126,543,467,343,1714,7837,559,2005-06
Seattle SuperSonics,0.427,3077,6711,0.459,605,1631,0.37093807480073576,0.785,2472,5080,0.48661417322834644,35,47,1652,2104,1013,2233,3246,1696,1208,622,306,399,1933,8411,-248,2005-06
Toronto Raptors,0.329,3013,6639,0.454,608,1620,0.37530864197530867,0.791,2405,5019,0.4791791193464834,27,55,1653,2089,864,2291,3155,1593,1071,529,272,359,1965,8287,-245,2005-06
Utah Jazz,0.5,2744,6207,0.442,311,925,0.3362162162162162,0.719,2433,5282,0.4606209769026884,41,41,1774,2466,1071,2380,3451,1772,1290,524,492,463,2032,7573,-216,2005-06
Washington Wizards,0.512,2975,6656,0.447,497,1394,0.3565279770444763,0.757,2478,5262,0.4709236031927024,42,40,1889,2496,1035,2344,3379,1523,1143,658,339,341,1855,8336,152,2005-06
Atlanta Hawks,0.366,2831,6372,0.444,341,1038,0.3285163776493256,0.761,2490,5334,0.4668166479190101,30,52,1677,2203,976,2312,3288,1573,1306,609,446,421,1970,7680,-390,2006-07
Boston Celtics,0.293,2858,6454,0.443,471,1283,0.36710833982852686,0.767,2387,5171,0.4616128408431638,24,58,1670,2178,918,2391,3309,1630,1350,589,382,449,1971,7857,-280,2006-07
Charlotte Bobcats,0.402,2960,6643,0.446,457,1280,0.35703125,0.734,2503,5363,0.466716390080179,33,49,1568,2136,920,2346,3266,1836,1224,638,369,437,1985,7945,-307,2006-07
Chicago Bulls,0.598,3046,6663,0.457,480,1237,0.3880355699272433,0.734,2566,5426,0.4729082196830077,49,33,1528,2083,984,2597,3581,1832,1310,639,445,433,1908,8100,411,2006-07
Cleveland Cavaliers,0.61,2978,6658,0.447,494,1404,0.35185185185185186,0.696,2484,5254,0.4727826417967263,50,32,1484,2133,1039,2529,3568,1708,1177,625,353,349,1781,7934,314,2006-07
Dallas Mavericks,0.817,3010,6442,0.467,535,1404,0.38105413105413105,0.805,2475,5038,0.4912663755458515,67,15,1646,2045,920,2515,3435,1632,1140,560,408,312,1837,8201,592,2006-07
Denver Nuggets,0.549,3164,6805,0.465,484,1440,0.33611111111111114,0.746,2680,5365,0.4995340167753961,45,37,1827,2449,1001,2558,3559,1920,1352,678,435,424,1756,8639,133,2006-07
Detroit Pistons,0.646,2942,6484,0.454,449,1305,0.34406130268199236,0.774,2493,5179,0.4813670592778529,53,29,1539,1988,948,2374,3322,1768,1001,583,472,290,1672,7872,341,2006-07
Golden State Warriors,0.512,3261,7048,0.463,700,1966,0.3560528992878942,0.717,2561,5082,0.503935458480913,42,40,1515,2113,941,2455,3396,1950,1309,750,466,399,1933,8737,-28,2006-07
Houston Rockets,0.634,2906,6528,0.445,705,1893,0.3724247226624406,0.753,2201,4635,0.4748651564185545,52,30,1436,1906,880,2673,3553,1704,1162,583,337,353,1710,7953,398,2006-07
Indiana Pacers,0.427,2872,6561,0.438,481,1389,0.3462922966162707,0.76,2391,5172,0.4622969837587007,35,47,1615,2125,990,2441,3431,1680,1335,599,447,410,1912,7840,-200,2006-07
Los Angeles Clippers,0.488,2880,6318,0.456,314,903,0.3477297895902547,0.788,2566,5415,0.47386888273314864,40,42,1769,2245,888,2484,3372,1762,1239,596,472,321,1858,7843,-38,2006-07
Los Angeles Lakers,0.512,3103,6664,0.466,608,1724,0.35266821345707655,0.747,2495,4940,0.5050607287449392,42,40,1660,2221,886,2495,3381,1850,1273,600,421,409,1889,8474,-6,2006-07
Memphis Grizzlies,0.268,2998,6448,0.465,500,1362,0.3671071953010279,0.761,2498,5086,0.4911521824616595,22,60,1835,2410,866,2375,3241,1680,1343,564,407,450,1827,8331,-422,2006-07
Miami Heat,0.537,2919,6288,0.464,528,1539,0.34307992202729043,0.69,2391,4749,0.5034744156664561,44,38,1393,2019,817,2526,3343,1681,1201,566,442,314,1749,7759,-75,2006-07
Milwaukee Bucks,0.341,3121,6714,0.465,524,1472,0.35597826086956524,0.733,2597,5242,0.4954215948111408,28,54,1406,1919,941,2272,3213,1771,1240,587,224,433,1821,8172,-359,2006-07
Minnesota Timberwolves,0.39,2997,6502,0.461,384,1089,0.3526170798898072,0.792,2613,5413,0.48272676888970995,32,50,1499,1892,819,2473,3292,1848,1278,532,325,360,1758,7877,-301,2006-07
New Jersey Nets,0.5,2913,6379,0.457,609,1676,0.36336515513126494,0.727,2304,4703,0.4899000637890708,41,41,1566,2153,822,2525,3347,1962,1212,499,273,369,1869,8001,-63,2006-07
New Orleans/Oklahoma City Hornets,0.476,2971,6674,0.445,455,1256,0.3622611464968153,0.74,2516,5418,0.4643779992617202,39,43,1436,1941,1025,2512,3537,1537,1187,522,347,392,1620,7833,-129,2006-07
New York Knicks,0.402,2903,6356,0.457,474,1370,0.345985401459854,0.715,2429,4986,0.4871640593662254,33,49,1714,2396,1032,2516,3548,1532,1405,543,260,406,1932,7994,-234,2006-07
Orlando Magic,0.488,2875,6090,0.472,342,962,0.35550935550935553,0.702,2533,5128,0.49395475819032764,40,42,1679,2393,920,2418,3338,1525,1392,565,416,376,1904,7771,64,2006-07
Philadelphia 76ers,0.427,2932,6408,0.458,284,823,0.3450789793438639,0.767,2648,5585,0.4741271262309758,35,47,1637,2135,899,2353,3252,1669,1258,590,390,320,1671,7785,-248,2006-07
Phoenix Suns,0.744,3388,6855,0.494,785,1965,0.3994910941475827,0.808,2603,4890,0.5323108384458077,61,21,1476,1827,737,2583,3320,2122,1189,553,394,304,1659,9037,599,2006-07
Portland Trail Blazers,0.39,2874,6392,0.45,426,1232,0.3457792207792208,0.769,2448,5160,0.4744186046511628,32,50,1543,2006,923,2299,3222,1513,1236,555,380,380,1931,7717,-352,2006-07
Sacramento Kings,0.402,2941,6532,0.45,530,1513,0.3502974223397224,0.765,2411,5019,0.4803745766088862,33,49,1891,2473,797,2396,3193,1665,1194,671,265,405,1792,8303,-148,2006-07
San Antonio Spurs,0.707,2999,6328,0.474,595,1561,0.3811659192825112,0.751,2404,4767,0.5043003985735264,58,24,1486,1980,761,2577,3338,1814,1137,587,417,337,1588,8079,691,2006-07
Seattle SuperSonics,0.378,3047,6628,0.46,525,1451,0.36181943487250173,0.791,2522,5177,0.48715472281243966,31,51,1511,1911,928,2322,3250,1695,1268,631,301,341,1801,8130,-237,2006-07
Toronto Raptors,0.573,3032,6547,0.463,531,1464,0.36270491803278687,0.788,2501,5083,0.492032264410781,47,35,1562,1983,755,2480,3235,1822,1104,581,321,317,1672,8157,81,2006-07
Utah Jazz,0.622,3069,6471,0.474,354,1056,0.3352272727272727,0.743,2715,5415,0.5013850415512465,51,31,1830,2462,1030,2456,3486,2024,1277,577,339,438,2067,8322,235,2006-07
Washington Wizards,0.5,3070,6820,0.45,561,1614,0.3475836431226766,0.765,2509,5206,0.48194391087207067,41,41,1855,2425,998,2379,3377,1660,1133,635,375,380,1823,8556,-42,2006-07
Atlanta Hawks,0.451,2975,6552,0.454,384,1078,0.3562152133580705,0.772,2591,5474,0.47332846181951044,37,45,1720,2227,1008,2454,3462,1804,1223,600,448,421,1673,8054,-149,2007-08
Boston Celtics,0.805,2986,6286,0.475,596,1564,0.38107416879795397,0.771,2390,4722,0.5061414654807285,66,16,1677,2176,830,2615,3445,1833,1246,696,379,389,1864,8245,841,2007-08
Charlotte Bobcats,0.39,2960,6554,0.452,529,1443,0.3665973665973666,0.714,2431,5111,0.47564077479945216,32,50,1510,2115,892,2440,3332,1748,1204,614,402,476,1777,7959,-359,2007-08
Chicago Bulls,0.402,2987,6861,0.435,474,1305,0.3632183908045977,0.756,2513,5556,0.4523038156947444,33,49,1533,2029,1050,2478,3528,1811,1197,635,429,465,1784,7981,-253,2007-08
Cleveland Cavaliers,0.549,2937,6697,0.439,552,1544,0.35751295336787564,0.717,2385,5153,0.4628371822239472,45,37,1477,2061,1092,2563,3655,1640,1145,579,427,388,1712,7903,-29,2007-08
Dallas Mavericks,0.622,3025,6515,0.464,494,1403,0.35210263720598717,0.814,2531,5112,0.4951095461658842,51,31,1690,2075,883,2643,3526,1720,1037,490,402,357,1786,8234,372,2007-08
Denver Nuggets,0.61,3307,7038,0.47,569,1605,0.3545171339563863,0.751,2738,5433,0.5039572979937419,50,32,1891,2519,918,2698,3616,2024,1203,752,551,393,1731,9074,304,2007-08
Detroit Pistons,0.72,2999,6551,0.458,487,1330,0.3661654135338346,0.767,2512,5221,0.48113388239800803,59,23,1507,1965,974,2423,3397,1831,956,583,472,319,1688,7992,606,2007-08
Golden State Warriors,0.585,3403,7406,0.459,761,2185,0.3482837528604119,0.752,2642,5221,0.5060333269488604,48,34,1538,2044,1045,2496,3541,1833,1082,744,377,413,1875,9105,181,2007-08
Houston Rockets,0.671,3003,6698,0.448,583,1707,0.341534856473345,0.726,2420,4991,0.484872770987778,55,27,1342,1848,1002,2659,3661,1757,1125,598,420,379,1609,7931,384,2007-08
Indiana Pacers,0.439,3102,6993,0.444,755,2021,0.37357743691241957,0.768,2347,4972,0.47204344328238135,36,46,1568,2042,904,2633,3537,1864,1236,623,412,416,1921,8527,-115,2007-08
Los Angeles Clippers,0.28,2820,6445,0.438,350,1079,0.3243744207599629,0.781,2470,5366,0.4603056280283265,23,59,1702,2178,800,2491,3291,1732,1180,557,398,388,1745,7692,-596,2007-08
Los Angeles Lakers,0.695,3248,6818,0.476,662,1751,0.37806967447173045,0.769,2586,5067,0.5103611604499704,57,25,1746,2270,898,2722,3620,2003,1156,654,438,368,1691,8904,595,2007-08
Memphis Grizzlies,0.268,3060,6737,0.454,620,1779,0.3485103991006183,0.723,2440,4958,0.49213392496974584,22,60,1517,2097,848,2567,3415,1574,1251,503,386,403,1592,8257,-509,2007-08
Miami Heat,0.183,2808,6336,0.443,491,1373,0.35761107064821557,0.727,2317,4963,0.46685472496473907,15,67,1384,1903,743,2342,3085,1644,1202,589,355,341,1670,7491,-709,2007-08
Milwaukee Bucks,0.317,3026,6745,0.449,452,1313,0.34424980959634427,0.733,2574,5432,0.4738586156111929,26,56,1452,1980,1055,2363,3418,1760,1210,544,361,404,1748,7956,-565,2007-08
Minnesota Timberwolves,0.268,3076,6817,0.451,441,1259,0.35027799841143764,0.736,2635,5558,0.474091399784095,22,60,1246,1693,964,2428,3392,1630,1188,616,306,467,1885,7839,-556,2007-08
New Jersey Nets,0.415,2856,6450,0.443,498,1430,0.34825174825174826,0.736,2358,5020,0.4697211155378486,34,48,1647,2237,913,2520,3433,1925,1229,521,390,362,1855,7857,-415,2007-08
New Orleans Hornets,0.683,3164,6796,0.466,630,1621,0.38864898210980875,0.769,2534,5175,0.4896618357487923,56,26,1312,1707,937,2494,3431,1785,974,637,321,331,1531,8270,433,2007-08
New York Knicks,0.28,2967,6757,0.439,490,1454,0.33700137551581844,0.727,2477,5303,0.46709409768055815,23,59,1524,2095,1029,2457,3486,1530,1187,521,213,429,1761,7948,-542,2007-08
Orlando Magic,0.634,3058,6446,0.474,801,2074,0.3862102217936355,0.721,2257,4372,0.5162397072278133,52,30,1650,2288,768,2677,3445,1706,1173,520,333,344,1688,8567,448,2007-08
Philadelphia 76ers,0.488,3056,6648,0.46,302,952,0.3172268907563025,0.706,2754,5696,0.48349719101123595,40,42,1509,2137,1067,2370,3437,1673,1172,712,400,420,1620,7923,34,2007-08
Phoenix Suns,0.671,3392,6782,0.5,694,1764,0.3934240362811791,0.783,2698,5018,0.5376644081307294,55,27,1548,1977,720,2683,3403,2188,1184,532,518,311,1633,9026,414,2007-08
Portland Trail Blazers,0.5,2935,6546,0.448,538,1426,0.37727910238429174,0.767,2397,5120,0.4681640625,41,41,1412,1841,901,2438,3339,1733,1056,455,360,301,1642,7820,-80,2007-08
Sacramento Kings,0.463,3043,6558,0.464,510,1367,0.37307973664959765,0.798,2533,5191,0.4879599306492005,38,44,1812,2272,829,2456,3285,1567,1317,651,334,452,1839,8408,-185,2007-08
San Antonio Spurs,0.683,2938,6424,0.457,594,1610,0.368944099378882,0.761,2344,4814,0.48691316992106354,56,26,1350,1774,771,2612,3383,1718,1035,521,337,361,1537,7820,393,2007-08
Seattle SuperSonics,0.244,3125,7032,0.444,313,939,0.3333333333333333,0.77,2812,6093,0.4615132118824881,20,62,1436,1866,971,2688,3659,1748,1310,531,400,440,1680,7999,-718,2007-08
Toronto Raptors,0.5,3148,6726,0.468,572,1459,0.39204934886908843,0.812,2576,5267,0.4890829694323144,41,41,1347,1658,790,2496,3286,1953,959,570,336,333,1596,8215,238,2007-08
Utah Jazz,0.659,3279,6592,0.497,407,1095,0.37168949771689497,0.759,2872,5497,0.5224668000727669,54,28,1745,2298,942,2410,3352,2165,1200,717,355,420,1970,8710,564,2007-08
Washington Wizards,0.524,2986,6695,0.446,575,1614,0.3562577447335812,0.782,2411,5081,0.47451289116315687,43,39,1557,1991,1007,2404,3411,1607,1082,632,391,360,1606,8104,-27,2007-08
Atlanta Hawks,0.573,2956,6451,0.458,597,1633,0.3655848132271892,0.737,2359,4818,0.4896222498962225,47,35,1537,2085,870,2412,3282,1657,1048,603,376,354,1610,8046,129,2008-09
Boston Celtics,0.756,3075,6333,0.486,538,1355,0.3970479704797048,0.764,2537,4978,0.5096424266773805,62,20,1587,2076,869,2586,3455,1862,1280,621,387,389,1897,8275,616,2008-09
Charlotte Bobcats,0.427,2866,6299,0.455,490,1339,0.3659447348767737,0.74,2376,4960,0.4790322580645161,35,47,1455,1965,886,2366,3252,1741,1279,580,397,488,1754,7677,-104,2008-09
Chicago Bulls,0.5,3126,6846,0.457,493,1293,0.38128383604021654,0.796,2633,5553,0.47415811273185665,41,41,1633,2052,970,2481,3451,1732,1192,615,453,449,1709,8378,-23,2008-09
Cleveland Cavaliers,0.805,3022,6454,0.468,656,1670,0.39281437125748503,0.757,2366,4784,0.4945652173913043,66,16,1523,2012,886,2574,3460,1663,1045,593,435,338,1663,8223,732,2008-09
Dallas Mavericks,0.61,3128,6770,0.462,571,1632,0.34987745098039214,0.819,2557,5138,0.4976644608797197,50,32,1516,1852,909,2595,3504,1779,1043,591,429,334,1600,8343,162,2008-09
Denver Nuggets,0.659,3058,6510,0.47,548,1477,0.3710223425863236,0.76,2510,5033,0.4987085237432943,54,28,1891,2487,905,2507,3412,1820,1257,710,492,447,1874,8555,280,2008-09
Detroit Pistons,0.476,2981,6559,0.454,377,1079,0.3493975903614458,0.751,2604,5480,0.4751824817518248,39,43,1388,1849,949,2448,3397,1689,973,493,377,342,1712,7727,-40,2008-09
Golden State Warriors,0.354,3231,7055,0.458,550,1475,0.3728813559322034,0.791,2681,5580,0.48046594982078855,29,53,1893,2392,953,2492,3445,1711,1201,638,527,414,1842,8905,-307,2008-09
Houston Rockets,0.646,2959,6526,0.453,621,1656,0.375,0.805,2338,4870,0.48008213552361395,53,29,1531,1903,862,2662,3524,1662,1158,548,355,435,1553,8070,328,2008-09
Indiana Pacers,0.439,3220,7080,0.455,652,1725,0.3779710144927536,0.807,2568,5355,0.47955182072829133,36,46,1525,1890,924,2661,3585,1775,1189,573,434,444,1895,8617,-91,2008-09
Los Angeles Clippers,0.232,2955,6696,0.441,535,1513,0.3536021150033047,0.736,2420,5183,0.4669110553733359,19,63,1354,1839,890,2377,3267,1723,1221,572,482,414,1650,7799,-719,2008-09
Los Angeles Lakers,0.793,3307,6981,0.474,547,1516,0.3608179419525066,0.77,2760,5465,0.505032021957914,65,17,1607,2087,1015,2587,3602,1908,1103,718,420,392,1698,8768,628,2008-09
Memphis Grizzlies,0.293,2865,6311,0.454,398,1106,0.35985533453887886,0.756,2467,5205,0.4739673390970221,24,58,1570,2077,847,2337,3184,1423,1252,615,385,443,1777,7698,-448,2008-09
Miami Heat,0.524,3034,6646,0.457,582,1631,0.35683629675045986,0.754,2452,5015,0.4889332003988036,43,39,1411,1871,828,2411,3239,1671,1026,651,451,335,1696,8061,21,2008-09
Milwaukee Bucks,0.415,3009,6755,0.445,511,1408,0.36292613636363635,0.78,2498,5347,0.4671778567420984,34,48,1613,2067,973,2367,3340,1802,1154,609,308,376,1986,8142,-89,2008-09
Minnesota Timberwolves,0.293,2986,6766,0.441,543,1539,0.35282651072124754,0.769,2443,5227,0.46738090682992156,24,58,1504,1957,975,2442,3417,1674,1165,512,322,484,1785,8019,-403,2008-09
New Jersey Nets,0.415,2925,6536,0.448,652,1735,0.37579250720461094,0.779,2273,4801,0.4734430327015205,34,48,1542,1980,850,2415,3265,1636,1075,559,391,393,1838,8044,-200,2008-09
New Orleans Hornets,0.598,2911,6366,0.457,556,1526,0.36435124508519,0.807,2355,4840,0.4865702479338843,49,33,1479,1833,802,2453,3255,1609,1029,593,338,290,1665,7857,127,2008-09
New York Knicks,0.39,3157,7091,0.445,823,2284,0.36033274956217165,0.784,2334,4807,0.48554191803619723,32,50,1490,1900,911,2545,3456,1738,1174,610,204,437,1672,8627,-214,2008-09
Oklahoma City Thunder,0.28,2999,6716,0.447,328,949,0.34562697576396206,0.786,2671,5767,0.46315241893532166,23,59,1626,2069,999,2497,3496,1663,1330,608,371,407,1655,7952,-500,2008-09
Orlando Magic,0.72,2929,6416,0.457,817,2147,0.3805309734513274,0.715,2112,4269,0.4947294448348559,59,23,1611,2253,819,2728,3547,1593,1142,570,439,308,1664,8286,549,2008-09
Philadelphia 76ers,0.5,2997,6532,0.459,341,1072,0.3180970149253731,0.745,2656,5460,0.48644688644688644,41,41,1652,2216,1039,2336,3375,1647,1157,658,415,400,1650,7987,6,2008-09
Phoenix Suns,0.561,3373,6695,0.504,553,1445,0.38269896193771624,0.744,2820,5250,0.5371428571428571,46,36,1675,2251,900,2520,3420,1905,1288,589,420,369,1691,8974,158,2008-09
Portland Trail Blazers,0.659,3018,6494,0.465,596,1555,0.3832797427652733,0.765,2422,4939,0.49038266855638796,54,28,1521,1988,1060,2360,3420,1667,1055,550,402,319,1671,8153,438,2008-09
Sacramento Kings,0.207,2990,6685,0.447,586,1594,0.36762860727728985,0.798,2404,5091,0.47220585346690236,17,65,1682,2107,840,2366,3206,1619,1266,569,349,423,1910,8248,-718,2008-09
San Antonio Spurs,0.659,3042,6534,0.466,625,1620,0.38580246913580246,0.761,2417,4914,0.49185999185999185,54,28,1249,1641,728,2638,3366,1736,963,474,329,352,1546,7958,308,2008-09
Toronto Raptors,0.402,3054,6673,0.458,479,1289,0.3716058960434445,0.824,2575,5384,0.4782689450222883,33,49,1534,1861,802,2513,3315,1835,1098,523,390,386,1593,8121,-231,2008-09
Utah Jazz,0.585,3143,6623,0.475,392,1122,0.3493761140819964,0.771,2751,5501,0.5000908925649882,48,34,1814,2352,940,2423,3363,2024,1210,719,374,424,1830,8492,217,2008-09
Washington Wizards,0.232,2994,6655,0.45,395,1198,0.3297161936560935,0.767,2599,5457,0.4762690122778083,19,63,1494,1948,956,2330,3286,1641,1146,619,365,431,1679,7877,-612,2008-09
Atlanta Hawks,0.646,3181,6801,0.468,524,1455,0.36013745704467354,0.759,2657,5346,0.49700710811821924,53,29,1452,1914,969,2451,3420,1789,980,592,413,359,1632,8338,382,2009-10
Boston Celtics,0.61,3039,6294,0.483,499,1433,0.34822051639916257,0.746,2540,4861,0.5225262291709525,50,32,1559,2090,716,2449,3165,1930,1219,701,402,386,1816,8136,300,2009-10
Charlotte Bobcats,0.537,2858,6306,0.453,460,1331,0.3456048084147258,0.751,2398,4975,0.48201005025125626,44,38,1637,2180,858,2490,3348,1658,1290,632,446,502,1597,7813,120,2009-10
Chicago Bulls,0.5,3081,6825,0.451,352,1066,0.3302063789868668,0.754,2729,5759,0.4738669907970134,41,41,1479,1962,937,2715,3652,1704,1175,531,478,438,1648,7993,-134,2009-10
Cleveland Cavaliers,0.744,3101,6391,0.485,602,1582,0.3805309734513274,0.72,2499,4809,0.519650655021834,61,21,1569,2180,791,2692,3483,1835,1137,564,425,325,1591,8373,535,2009-10
Dallas Mavericks,0.671,3140,6760,0.464,558,1498,0.3724966622162884,0.816,2582,5262,0.4906879513492968,55,27,1526,1870,834,2586,3420,1917,1059,624,449,337,1563,8364,223,2009-10
Denver Nuggets,0.646,3124,6678,0.468,544,1517,0.35860250494396834,0.772,2580,5161,0.49990311955047473,53,29,1937,2508,889,2505,3394,1719,1136,683,417,438,1844,8729,335,2009-10
Detroit Pistons,0.329,2940,6602,0.445,374,1190,0.3142857142857143,0.728,2566,5412,0.47413155949741315,27,55,1455,1998,1053,2242,3295,1591,1100,596,313,401,1822,7709,-419,2009-10
Golden State Warriors,0.317,3329,7094,0.469,633,1687,0.3752222880853586,0.782,2696,5407,0.4986129091917884,26,56,1631,2085,753,2397,3150,1839,1204,761,340,407,1886,8922,-295,2009-10
Houston Rockets,0.512,3094,6923,0.447,646,1838,0.3514689880304679,0.772,2448,5085,0.4814159292035398,42,40,1561,2022,971,2471,3442,1790,1188,583,318,532,1712,8395,-30,2009-10
Indiana Pacers,0.39,3020,6823,0.443,659,1896,0.34757383966244726,0.775,2361,4927,0.47919626547594885,32,50,1564,2019,785,2618,3403,1730,1232,585,439,414,1848,8263,-247,2009-10
Los Angeles Clippers,0.354,3002,6601,0.455,483,1457,0.33150308853809196,0.73,2519,5144,0.48969673405909797,29,53,1362,1867,927,2502,3429,1810,1285,532,466,363,1581,7849,-521,2009-10
Los Angeles Lakers,0.695,3144,6875,0.457,532,1562,0.3405889884763124,0.765,2612,5313,0.49162431771127424,57,25,1519,1985,973,2662,3635,1730,1096,612,400,363,1592,8339,387,2009-10
Memphis Grizzlies,0.488,3223,6875,0.469,344,1020,0.33725490196078434,0.733,2879,5855,0.4917164816396242,40,42,1614,2202,1070,2496,3566,1543,1248,645,399,501,1655,8404,-124,2009-10
Miami Heat,0.573,2984,6518,0.458,494,1426,0.34642356241234223,0.752,2490,5092,0.4890023566378633,47,35,1452,1931,875,2553,3428,1548,1079,605,457,355,1710,7914,187,2009-10
Milwaukee Bucks,0.561,3050,6998,0.436,645,1813,0.3557639271924986,0.755,2405,5185,0.46383799421407906,46,36,1264,1675,965,2560,3525,1740,1085,580,385,421,1823,8009,139,2009-10
Minnesota Timberwolves,0.183,3106,6923,0.449,403,1181,0.34123624047417445,0.746,2703,5742,0.47074190177638453,15,67,1436,1926,962,2556,3518,1626,1333,597,306,442,1699,8051,-787,2009-10
New Jersey Nets,0.146,2813,6554,0.429,377,1185,0.3181434599156118,0.78,2436,5369,0.45371577574967403,12,70,1572,2015,897,2358,3255,1540,1182,573,393,421,1643,7575,-748,2009-10
New Orleans Hornets,0.451,3178,6842,0.464,571,1572,0.36323155216284986,0.778,2607,5270,0.49468690702087287,37,45,1293,1661,852,2450,3302,1828,1103,625,300,367,1606,8220,-202,2009-10
New York Knicks,0.354,3127,6876,0.455,743,2145,0.3463869463869464,0.782,2384,4731,0.5039103783555273,29,53,1376,1759,836,2477,3313,1772,1148,586,305,368,1638,8373,-313,2009-10
Oklahoma City Thunder,0.61,3063,6629,0.462,418,1229,0.34011391375101707,0.805,2645,5400,0.4898148148148148,50,32,1778,2210,960,2607,3567,1639,1227,654,481,384,1743,8322,286,2009-10
Orlando Magic,0.72,3005,6394,0.47,841,2241,0.37527889335118253,0.724,2164,4153,0.5210691066698772,59,23,1575,2176,810,2736,3546,1615,1155,512,456,288,1629,8426,614,2009-10
Philadelphia 76ers,0.329,3087,6706,0.46,474,1381,0.3432295438088342,0.756,2613,5325,0.49070422535211267,27,55,1366,1808,941,2421,3362,1723,1192,667,439,332,1677,8014,-320,2009-10
Phoenix Suns,0.659,3339,6788,0.492,730,1770,0.4124293785310734,0.77,2609,5018,0.5199282582702272,54,28,1631,2117,910,2616,3526,1912,1210,479,418,365,1713,9039,402,2009-10
Portland Trail Blazers,0.61,2974,6453,0.461,491,1388,0.3537463976945245,0.79,2483,5065,0.49022704837117476,50,32,1606,2033,913,2383,3296,1674,1012,523,350,333,1715,8045,271,2009-10
Sacramento Kings,0.305,3144,6895,0.456,482,1383,0.3485177151120752,0.726,2662,5512,0.48294629898403485,25,57,1430,1969,977,2518,3495,1679,1226,564,366,468,1827,8200,-358,2009-10
San Antonio Spurs,0.61,3150,6659,0.473,554,1547,0.3581124757595346,0.74,2596,5112,0.5078247261345853,50,32,1458,1969,887,2621,3508,1829,1116,516,381,417,1669,8312,417,2009-10
Toronto Raptors,0.488,3199,6631,0.482,518,1397,0.3707945597709377,0.764,2681,5234,0.5122277416889568,40,42,1618,2118,806,2507,3313,1804,1100,469,384,360,1819,8534,-146,2009-10
Utah Jazz,0.646,3227,6575,0.491,439,1207,0.3637116818558409,0.741,2788,5368,0.5193740685543964,53,29,1654,2233,872,2588,3460,2187,1246,675,400,445,1859,8547,438,2009-10
Washington Wizards,0.317,3008,6700,0.449,432,1225,0.3526530612244898,0.762,2576,5475,0.47050228310502284,26,56,1444,1895,966,2458,3424,1557,1219,493,421,415,1752,7892,-392,2009-10
Atlanta Hawks,0.537,2971,6429,0.462,502,1427,0.35178696566222845,0.779,2469,5002,0.4936025589764094,44,38,1346,1728,762,2460,3222,1802,1118,497,341,348,1554,7790,-67,2010-11
Boston Celtics,0.683,3023,6219,0.486,408,1119,0.3646112600536193,0.77,2615,5100,0.5127450980392156,56,26,1459,1895,639,2542,3181,1921,1195,676,344,364,1678,7913,440,2010-11
Charlotte Bobcats,0.415,2873,6365,0.451,393,1203,0.3266832917705736,0.756,2480,5162,0.4804339403332042,34,48,1511,1999,848,2444,3292,1728,1192,524,433,496,1637,7650,-328,2010-11
Chicago Bulls,0.756,3042,6587,0.462,511,1415,0.36113074204947,0.743,2531,5172,0.48936581593194123,62,20,1492,2008,967,2654,3621,1827,1161,592,468,477,1639,8087,600,2010-11
Cleveland Cavaliers,0.232,2886,6647,0.434,509,1489,0.34184016118200133,0.745,2377,5158,0.460837533927879,19,63,1546,2075,856,2449,3305,1720,1166,544,341,489,1648,7827,-739,2010-11
Dallas Mavericks,0.695,3069,6463,0.475,645,1768,0.36481900452488686,0.777,2424,4695,0.51629392971246,57,25,1437,1850,780,2618,3398,1954,1145,557,352,303,1575,8220,347,2010-11
Denver Nuggets,0.61,3145,6613,0.476,662,1704,0.3884976525821596,0.765,2483,4909,0.5058056630678346,50,32,1859,2430,791,2652,3443,1813,1157,605,352,488,1719,8811,390,2010-11
Detroit Pistons,0.366,3056,6647,0.46,472,1256,0.37579617834394907,0.737,2584,5391,0.479317380819885,30,52,1367,1854,931,2236,3167,1730,1067,595,328,381,1629,7951,-295,2010-11
Golden State Warriors,0.439,3251,7047,0.461,685,1749,0.39165237278444825,0.761,2566,5298,0.48433371083427706,36,46,1290,1695,955,2370,3325,1847,1198,737,406,352,1806,8477,-191,2010-11
Houston Rockets,0.524,3170,6975,0.454,677,1843,0.36733586543678787,0.801,2493,5132,0.4857755261106781,43,39,1668,2083,962,2549,3511,1955,1110,581,371,449,1641,8685,179,2010-11
Indiana Pacers,0.451,3003,6787,0.442,585,1653,0.35390199637023595,0.782,2418,5134,0.4709777950915465,37,45,1592,2035,914,2657,3571,1611,1262,584,456,467,1782,8183,-88,2010-11
Los Angeles Clippers,0.39,3015,6594,0.457,513,1519,0.3377221856484529,0.707,2502,5075,0.4930049261083744,32,50,1546,2187,955,2501,3456,1813,1343,585,402,404,1733,8089,-257,2010-11
Los Angeles Lakers,0.695,3128,6757,0.463,524,1487,0.3523873570948218,0.779,2604,5270,0.49411764705882355,57,25,1541,1979,989,2616,3605,1801,1073,602,422,372,1555,8321,501,2010-11
Memphis Grizzlies,0.561,3200,6801,0.471,309,926,0.33369330453563717,0.75,2891,5875,0.4920851063829787,46,36,1486,1981,970,2391,3361,1691,1145,771,441,505,1705,8195,192,2010-11
Miami Heat,0.707,3031,6301,0.481,547,1479,0.3698444895199459,0.769,2484,4822,0.5151389464952302,58,24,1760,2288,790,2666,3456,1639,1142,544,430,246,1674,8369,612,2010-11
Milwaukee Bucks,0.427,2814,6544,0.43,483,1414,0.3415841584158416,0.757,2331,5130,0.4543859649122807,35,47,1423,1881,862,2480,3342,1545,1103,617,399,392,1682,7534,-69,2010-11
Minnesota Timberwolves,0.207,3090,7014,0.441,589,1565,0.37635782747603835,0.768,2501,5449,0.45898329968801616,17,65,1519,1977,1085,2556,3641,1650,1398,592,422,447,1825,8288,-544,2010-11
New Jersey Nets,0.293,2918,6638,0.44,459,1337,0.3433059087509349,0.759,2459,5301,0.4638747406149783,24,58,1427,1881,909,2440,3349,1723,1152,458,384,375,1807,7722,-512,2010-11
New Orleans Hornets,0.561,2944,6416,0.459,444,1232,0.36038961038961037,0.765,2500,5184,0.48225308641975306,46,36,1452,1897,824,2468,3292,1691,1069,624,359,396,1719,7784,73,2010-11
New York Knicks,0.512,3140,6867,0.457,765,2081,0.367611725132148,0.809,2375,4786,0.49623903050564144,42,40,1689,2087,847,2470,3317,1757,1123,625,475,360,1743,8734,64,2010-11
Oklahoma City Thunder,0.671,3066,6609,0.464,487,1403,0.3471133285816108,0.823,2579,5206,0.49538993469074144,55,27,1977,2401,903,2604,3507,1672,1156,654,487,356,1836,8596,311,2010-11
Orlando Magic,0.634,2956,6411,0.461,770,2103,0.3661436043747028,0.692,2186,4308,0.5074280408542247,52,30,1453,2101,864,2679,3543,1636,1224,548,384,310,1640,8135,448,2010-11
Philadelphia 76ers,0.5,3125,6776,0.461,443,1248,0.35496794871794873,0.77,2682,5528,0.48516642547033284,41,41,1426,1851,850,2578,3428,1861,1063,621,355,376,1592,8119,123,2010-11
Phoenix Suns,0.488,3219,6844,0.47,701,1857,0.3774905761981691,0.759,2518,4987,0.5049127732103469,40,42,1472,1939,821,2478,3299,1945,1169,545,357,356,1666,8611,-73,2010-11
Portland Trail Blazers,0.585,2951,6599,0.447,518,1503,0.34464404524284764,0.804,2433,5096,0.47743328100470955,48,34,1476,1835,996,2230,3226,1736,1070,660,358,339,1585,7896,125,2010-11
Sacramento Kings,0.293,3134,6979,0.449,428,1277,0.3351605324980423,0.734,2706,5702,0.4745703262013329,24,58,1455,1981,1071,2526,3597,1675,1324,608,391,464,1805,8151,-438,2010-11
San Antonio Spurs,0.744,3148,6628,0.475,685,1727,0.39664157498552405,0.767,2463,4901,0.50255049989798,61,21,1521,1984,829,2603,3432,1836,1101,602,372,374,1556,8502,468,2010-11
Toronto Raptors,0.268,3144,6755,0.465,345,1091,0.3162236480293309,0.755,2799,5664,0.4941737288135593,22,60,1491,1976,963,2343,3306,1795,1206,581,350,456,1807,8124,-515,2010-11
Utah Jazz,0.476,3064,6590,0.465,435,1256,0.3463375796178344,0.771,2629,5334,0.4928758905136858,39,43,1590,2061,898,2338,3236,1921,1175,629,484,411,1865,8153,-150,2010-11
Washington Wizards,0.28,3048,6888,0.443,392,1182,0.3316412859560068,0.745,2656,5706,0.46547493866105855,23,59,1489,1999,1013,2374,3387,1592,1258,665,502,413,1850,7977,-607,2010-11
Atlanta Hawks,0.606,2429,5348,0.454,492,1330,0.3699248120300752,0.74,1937,4018,0.48208063713290195,40,26,1025,1385,652,2066,2718,1481,921,536,303,313,1178,6375,227,2011-12
Boston Celtics,0.591,2341,5086,0.46,363,988,0.3674089068825911,0.778,1978,4098,0.4826744753538311,39,27,1017,1308,509,2051,2560,1557,979,498,362,304,1315,6062,166,2011-12
Charlotte Bobcats,0.106,2193,5293,0.414,263,892,0.2948430493273543,0.745,1930,4401,0.43853669620540786,7,59,1090,1463,677,1894,2571,1326,957,397,361,378,1249,5739,-918,2011-12
Chicago Bulls,0.758,2467,5462,0.452,419,1117,0.37511190689346463,0.722,2048,4345,0.4713463751438435,50,16,1006,1394,915,2165,3080,1527,923,456,388,343,1139,6359,540,2011-12
Cleveland Cavaliers,0.318,2261,5360,0.422,440,1273,0.34564021995286726,0.716,1821,4087,0.44555908979691705,21,45,1178,1645,841,1949,2790,1308,1017,466,262,409,1317,6140,-475,2011-12
Dallas Mavericks,0.545,2398,5412,0.443,497,1464,0.3394808743169399,0.771,1901,3948,0.4815096251266464,36,30,1029,1334,665,2157,2822,1380,926,565,337,265,1226,6322,63,2011-12
Denver Nuggets,0.576,2572,5404,0.476,435,1311,0.3318077803203661,0.735,2137,4093,0.5221109210847789,38,28,1293,1760,738,2105,2843,1581,1015,540,330,439,1297,6872,190,2011-12
Detroit Pistons,0.379,2291,5232,0.438,317,916,0.3460698689956332,0.752,1974,4316,0.45736793327154773,25,41,1098,1461,775,1882,2657,1232,1033,460,278,348,1293,5997,-316,2011-12
Golden State Warriors,0.348,2489,5443,0.457,524,1351,0.38786084381939306,0.77,1965,4092,0.4802052785923754,23,43,951,1235,640,1947,2587,1470,915,528,362,328,1410,6453,-225,2011-12
Houston Rockets,0.515,2489,5543,0.449,478,1330,0.3593984962406015,0.782,2011,4213,0.4773320674103964,34,32,1018,1301,769,2014,2783,1404,955,496,319,340,1347,6474,15,2011-12
Indiana Pacers,0.636,2354,5375,0.438,392,1064,0.3684210526315789,0.782,1962,4311,0.4551148225469729,42,24,1349,1724,826,2070,2896,1228,925,523,357,398,1430,6449,218,2011-12
Los Angeles Clippers,0.606,2439,5366,0.455,514,1441,0.3566967383761277,0.68,1925,3925,0.49044585987261147,40,26,1046,1538,800,1943,2743,1385,879,556,315,296,1399,6438,169,2011-12
Los Angeles Lakers,0.621,2429,5319,0.457,362,1112,0.3255395683453237,0.756,2067,4207,0.49132398383646303,41,25,1202,1589,799,2251,3050,1485,997,390,351,302,1109,6422,94,2011-12
Memphis Grizzlies,0.621,2425,5422,0.447,277,849,0.32626619552414604,0.759,2148,4573,0.4697135359720096,41,25,1142,1504,831,1944,2775,1290,955,631,345,363,1316,6269,133,2011-12
Miami Heat,0.697,2446,5212,0.469,370,1030,0.3592233009708738,0.775,2076,4182,0.4964131994261119,46,20,1238,1598,686,2060,2746,1317,1002,585,355,280,1282,6500,395,2011-12
Milwaukee Bucks,0.47,2502,5652,0.443,436,1265,0.34466403162055337,0.774,2066,4387,0.47093685890129927,31,35,1095,1415,820,1983,2803,1550,929,548,335,297,1273,6535,18,2011-12
Minnesota Timberwolves,0.394,2355,5434,0.433,473,1423,0.3323963457484188,0.771,1882,4011,0.46920967339815506,26,40,1281,1662,797,2089,2886,1290,1001,436,293,377,1212,6464,-145,2011-12
New Jersey Nets,0.333,2262,5320,0.425,507,1481,0.34233625928426736,0.777,1755,3839,0.45715029955717634,22,44,1113,1433,783,1879,2662,1311,995,493,260,330,1268,6144,-395,2011-12
New Orleans Hornets,0.318,2300,5103,0.451,259,777,0.3333333333333333,0.757,2041,4326,0.4717984281091077,21,45,1057,1397,724,1991,2715,1368,1024,488,316,380,1324,5916,-248,2011-12
New York Knicks,0.545,2365,5335,0.443,517,1538,0.3361508452535761,0.741,1848,3797,0.4867000263365815,36,30,1211,1634,743,2012,2755,1328,1056,622,276,334,1391,6458,211,2011-12
Oklahoma City Thunder,0.712,2462,5229,0.471,472,1317,0.3583902809415338,0.806,1990,3912,0.5086912065439673,47,19,1406,1744,726,2157,2883,1224,1079,498,539,321,1352,6802,404,2011-12
Orlando Magic,0.561,2275,5162,0.441,670,1785,0.3753501400560224,0.66,1605,3377,0.4752739117559964,37,29,995,1508,742,2060,2802,1321,984,451,275,273,1168,6215,52,2011-12
Philadelphia 76ers,0.53,2471,5516,0.448,349,963,0.3624091381100727,0.742,2122,4553,0.4660663298923787,35,31,889,1198,704,2144,2848,1453,738,526,340,316,1157,6180,280,2011-12
Phoenix Suns,0.5,2495,5445,0.458,444,1295,0.34285714285714286,0.757,2051,4150,0.49421686746987953,33,33,1058,1397,717,2035,2752,1486,928,431,366,288,1233,6492,-16,2011-12
Portland Trail Blazers,0.424,2402,5417,0.443,478,1382,0.3458755426917511,0.796,1924,4035,0.4768277571251549,28,38,1133,1423,735,1949,2684,1349,935,528,322,314,1251,6415,-41,2011-12
Sacramento Kings,0.333,2490,5712,0.436,411,1301,0.3159108378170638,0.736,2079,4411,0.4713216957605985,22,44,1127,1532,882,1947,2829,1271,952,561,323,423,1287,6518,-375,2011-12
San Antonio Spurs,0.758,2611,5463,0.478,552,1405,0.39288256227758006,0.748,2059,4058,0.5073928043371119,50,16,1067,1427,683,2153,2836,1528,895,490,293,330,1143,6841,473,2011-12
Toronto Raptors,0.348,2268,5154,0.44,365,1075,0.3395348837209302,0.77,1903,4079,0.4665359156656043,23,43,1085,1410,697,2074,2771,1382,1001,429,321,322,1532,5986,-218,2011-12
Utah Jazz,0.545,2523,5531,0.456,273,845,0.3230769230769231,0.754,2250,4686,0.4801536491677337,36,30,1258,1668,861,2055,2916,1439,936,545,385,375,1441,6577,41,2011-12
Washington Wizards,0.303,2414,5475,0.441,344,1075,0.32,0.727,2070,4400,0.47045454545454546,20,46,1008,1386,775,1975,2750,1262,1008,527,417,300,1405,6180,-317,2011-12
Atlanta Hawks,0.537,3084,6644,0.464,706,1901,0.371383482377696,0.715,2378,4743,0.5013704406493781,44,38,1158,1619,758,2593,3351,2007,1219,664,369,350,1473,8032,33,2012-13
Boston Celtics,0.506,3001,6459,0.465,498,1390,0.35827338129496406,0.776,2503,5069,0.4937857565594792,41,40,1318,1698,654,2533,3187,1843,1181,667,365,378,1717,7818,-18,2012-13
Brooklyn Nets,0.598,2942,6544,0.45,628,1760,0.3568181818181818,0.731,2314,4784,0.483695652173913,49,33,1432,1958,1047,2460,3507,1668,1206,599,391,390,1500,7944,146,2012-13
Charlotte Bobcats,0.256,2823,6649,0.425,469,1399,0.33523945675482486,0.75,2354,5250,0.4483809523809524,21,61,1546,2060,917,2389,3306,1587,1153,591,479,565,1561,7661,-757,2012-13
Chicago Bulls,0.549,2926,6698,0.437,446,1265,0.3525691699604743,0.773,2480,5433,0.45646972206883857,45,37,1343,1738,1026,2514,3540,1886,1171,588,417,477,1617,7641,26,2012-13
Cleveland Cavaliers,0.293,2993,6901,0.434,547,1581,0.3459835547122075,0.756,2446,5320,0.45977443609022556,24,58,1380,1826,1004,2359,3363,1694,1149,647,334,560,1737,7913,-384,2012-13
Dallas Mavericks,0.5,3182,6892,0.462,606,1628,0.37223587223587223,0.793,2576,5264,0.48936170212765956,41,41,1323,1669,767,2670,3437,1906,1144,648,454,340,1698,8293,-49,2012-13
Denver Nuggets,0.695,3339,6983,0.478,521,1518,0.3432147562582345,0.701,2818,5465,0.5156450137236962,57,25,1505,2148,1092,2601,3693,2002,1253,762,533,554,1682,8704,417,2012-13
Detroit Pistons,0.354,2979,6638,0.449,513,1440,0.35625,0.699,2466,5198,0.47441323585994616,29,53,1307,1870,991,2463,3454,1742,1241,574,400,472,1623,7778,-327,2012-13
Golden State Warriors,0.573,3130,6840,0.458,658,1632,0.40318627450980393,0.79,2472,5208,0.47465437788018433,47,35,1378,1744,885,2801,3686,1845,1236,567,346,399,1753,8296,73,2012-13
Houston Rockets,0.549,3124,6782,0.461,867,2369,0.3659772055719713,0.754,2257,4413,0.5114434624971674,45,37,1573,2087,909,2652,3561,1902,1348,679,359,498,1662,8688,285,2012-13
Indiana Pacers,0.605,2845,6525,0.436,555,1599,0.34709193245778613,0.746,2290,4926,0.464880227365002,49,32,1429,1915,1043,2671,3714,1645,1227,580,513,459,1623,7674,326,2012-13
Los Angeles Clippers,0.683,3160,6608,0.478,627,1752,0.3578767123287671,0.711,2533,4856,0.5216227347611203,56,26,1342,1888,938,2475,3413,1958,1197,784,461,335,1716,8289,529,2012-13
Los Angeles Lakers,0.549,3041,6640,0.458,715,2015,0.3548387096774194,0.692,2326,4625,0.5029189189189189,45,37,1584,2289,942,2732,3674,1818,1232,576,429,396,1467,8381,95,2012-13
Memphis Grizzlies,0.683,2964,6679,0.444,382,1107,0.34507678410117437,0.773,2582,5572,0.4633883704235463,56,26,1349,1746,1059,2445,3504,1715,1144,703,436,450,1660,7659,340,2012-13
Miami Heat,0.805,3148,6348,0.496,717,1809,0.3963515754560531,0.754,2431,4539,0.5355805243445693,66,16,1423,1887,676,2490,3166,1890,1143,710,441,262,1533,8436,645,2012-13
Milwaukee Bucks,0.463,3128,7197,0.435,601,1670,0.3598802395209581,0.736,2527,5527,0.45721005970689343,38,44,1251,1700,1068,2537,3605,1876,1156,685,550,362,1554,8108,-123,2012-13
Minnesota Timberwolves,0.378,2943,6702,0.439,450,1475,0.3050847457627119,0.742,2493,5227,0.4769466233020853,31,51,1515,2042,973,2473,3446,1836,1214,700,387,481,1509,7851,-194,2012-13
New Orleans Hornets,0.329,2955,6589,0.448,535,1474,0.36295793758480327,0.776,2420,5115,0.4731182795698925,27,55,1269,1636,988,2426,3414,1721,1193,520,440,492,1673,7714,-317,2012-13
New York Knicks,0.659,2996,6689,0.448,891,2371,0.3757908055672712,0.759,2105,4318,0.4874942102825382,54,28,1313,1729,890,2436,3326,1579,988,672,294,327,1650,8196,347,2012-13
Oklahoma City Thunder,0.732,3126,6504,0.481,598,1588,0.3765743073047859,0.828,2528,4916,0.5142392188771359,60,22,1819,2196,854,2725,3579,1753,1253,679,624,322,1654,8669,755,2012-13
Orlando Magic,0.244,3093,6904,0.448,506,1537,0.3292127521145088,0.755,2587,5367,0.4820197503260667,20,62,1026,1359,890,2612,3502,1871,1191,528,358,430,1591,7718,-573,2012-13
Philadelphia 76ers,0.415,3059,6895,0.444,518,1438,0.36022253129346316,0.729,2541,5457,0.46564046179219354,34,48,1004,1377,896,2493,3389,1867,1070,609,384,396,1505,7640,-274,2012-13
Phoenix Suns,0.305,3061,6917,0.443,480,1455,0.32989690721649484,0.744,2581,5462,0.47253753203954596,25,57,1203,1618,959,2454,3413,1855,1278,659,434,421,1688,7805,-530,2012-13
Portland Trail Blazers,0.402,3009,6715,0.448,673,1904,0.35346638655462187,0.776,2336,4811,0.48555393889004367,33,49,1304,1680,874,2474,3348,1784,1203,538,353,359,1518,7995,-260,2012-13
Sacramento Kings,0.341,3086,6904,0.447,610,1681,0.36287923854848303,0.769,2476,5223,0.47405705533218456,28,54,1437,1869,943,2385,3328,1708,1199,671,342,517,1717,8219,-400,2012-13
San Antonio Spurs,0.707,3210,6675,0.481,663,1764,0.3758503401360544,0.791,2547,4911,0.5186316432498472,58,24,1365,1725,666,2721,3387,2058,1206,695,446,405,1427,8448,525,2012-13
Toronto Raptors,0.415,2979,6685,0.446,571,1665,0.3429429429429429,0.788,2408,5020,0.4796812749003984,34,48,1442,1831,871,2426,3297,1765,1124,595,392,387,1836,7971,-121,2012-13
Utah Jazz,0.524,3046,6710,0.454,507,1385,0.36606498194945847,0.764,2539,5325,0.4768075117370892,43,39,1439,1883,989,2457,3446,1859,1210,690,515,480,1750,8038,-7,2012-13
Washington Wizards,0.354,2910,6693,0.435,545,1495,0.36454849498327757,0.733,2365,5198,0.4549826856483263,29,53,1279,1746,887,2652,3539,1775,1238,598,376,358,1681,7644,-208,2012-13
Atlanta Hawks,0.463,3061,6688,0.458,768,2116,0.3629489603024575,0.781,2293,4572,0.5015310586176728,38,44,1392,1782,713,2565,3278,2041,1251,680,326,354,1577,8282,-39,2013-14
Boston Celtics,0.305,2996,6883,0.435,575,1729,0.3325621746674378,0.777,2421,5154,0.46973224679860304,25,57,1325,1706,980,2505,3485,1726,1261,584,343,373,1743,7892,-366,2013-14
Brooklyn Nets,0.537,2931,6391,0.459,709,1922,0.3688865764828304,0.753,2222,4469,0.49720295368091294,44,38,1508,2002,721,2407,3128,1714,1191,705,311,337,1777,8079,-82,2013-14
Charlotte Bobcats,0.524,2976,6730,0.442,516,1471,0.35078178110129166,0.737,2460,5259,0.4677695379349686,43,39,1474,2000,776,2724,3500,1778,1010,499,421,415,1493,7942,-18,2013-14
Chicago Bulls,0.585,2843,6577,0.432,508,1459,0.34818368745716244,0.779,2335,5118,0.45623290347792106,48,34,1486,1908,937,2683,3620,1860,1223,594,424,490,1565,7680,152,2013-14
Cleveland Cavaliers,0.402,3036,6955,0.437,584,1640,0.35609756097560974,0.751,2452,5315,0.4613358419567262,33,49,1398,1861,989,2629,3618,1738,1163,579,304,461,1640,8054,-270,2013-14
Dallas Mavericks,0.598,3249,6858,0.474,721,1877,0.38412360149174213,0.795,2528,4981,0.5075286087131098,49,33,1378,1733,840,2514,3354,1935,1110,704,356,288,1636,8597,197,2013-14
Denver Nuggets,0.439,3147,7042,0.447,702,1959,0.35834609494640124,0.726,2445,5083,0.48101514853433014,36,46,1563,2154,1009,2717,3726,1838,1305,615,459,459,1890,8559,-176,2013-14
Detroit Pistons,0.354,3182,7124,0.447,507,1580,0.3208860759493671,0.67,2675,5544,0.4825036075036075,29,53,1415,2111,1196,2525,3721,1714,1193,687,395,403,1666,8286,-300,2013-14
Golden State Warriors,0.622,3236,7005,0.462,774,2037,0.3799705449189985,0.753,2462,4968,0.49557165861513686,51,31,1303,1731,896,2819,3715,1912,1247,642,407,342,1784,8549,394,2013-14
Houston Rockets,0.659,3118,6603,0.472,779,2179,0.3575034419458467,0.712,2339,4424,0.5287070524412296,54,28,1814,2549,920,2797,3717,1755,1323,621,461,460,1676,8829,374,2013-14
Indiana Pacers,0.683,2949,6573,0.449,550,1542,0.35667963683527887,0.779,2399,5031,0.4768435698668257,56,26,1485,1907,834,2831,3665,1651,1237,550,446,378,1675,7933,361,2013-14
Los Angeles Clippers,0.695,3208,6761,0.474,693,1966,0.35249237029501523,0.73,2515,4795,0.5245046923879041,57,25,1741,2384,858,2668,3526,2016,1136,703,397,284,1767,8850,572,2013-14
Los Angeles Lakers,0.329,3139,6980,0.45,774,2032,0.3809055118110236,0.757,2365,4948,0.47797089733225545,27,55,1390,1835,745,2620,3365,2006,1239,611,446,387,1627,8442,-516,2013-14
Memphis Grizzlies,0.61,3122,6723,0.464,405,1147,0.35309503051438534,0.741,2717,5576,0.48726685796269725,50,32,1235,1666,950,2526,3476,1792,1124,631,375,410,1568,7884,129,2013-14
Miami Heat,0.659,3142,6272,0.501,665,1829,0.3635866593767086,0.76,2477,4443,0.5575061895115913,54,28,1431,1884,627,2397,3024,1847,1212,732,367,256,1596,8380,390,2013-14
Milwaukee Bucks,0.183,2952,6737,0.438,548,1553,0.3528654217643271,0.747,2404,5184,0.4637345679012346,15,67,1377,1843,971,2399,3370,1760,1238,541,403,413,1713,7829,-671,2013-14
Minnesota Timberwolves,0.488,3189,7175,0.444,600,1757,0.3414911781445646,0.778,2589,5418,0.4778516057585825,40,42,1790,2301,1024,2644,3668,1963,1142,718,297,457,1504,8768,219,2013-14
New Orleans Pelicans,0.415,3101,6761,0.459,486,1303,0.37298541826554105,0.769,2615,5458,0.47911322828875047,34,48,1489,1936,933,2486,3419,1745,1129,647,523,504,1857,8177,-222,2013-14
New York Knicks,0.451,3027,6739,0.449,759,2038,0.37242394504416093,0.761,2268,4701,0.4824505424377792,37,45,1271,1670,870,2437,3307,1641,1063,631,367,277,1815,8084,-65,2013-14
Oklahoma City Thunder,0.72,3194,6782,0.471,664,1839,0.3610657966286025,0.806,2530,4943,0.5118349180659518,59,23,1653,2052,887,2781,3668,1794,1256,678,501,296,1858,8705,520,2013-14
Orlando Magic,0.28,3022,6784,0.445,563,1596,0.35275689223057644,0.763,2459,5188,0.47397841171935234,23,59,1307,1714,794,2654,3448,1726,1222,630,350,445,1678,7914,-446,2013-14
Philadelphia 76ers,0.232,3108,7150,0.435,577,1847,0.3123984840281538,0.71,2531,5303,0.47727701301150294,19,63,1362,1918,949,2556,3505,1791,1384,765,330,558,1844,8155,-857,2013-14
Phoenix Suns,0.585,3172,6845,0.463,765,2055,0.3722627737226277,0.758,2407,4790,0.5025052192066806,48,34,1520,2004,928,2601,3529,1563,1258,688,374,332,1798,8629,216,2013-14
Portland Trail Blazers,0.659,3207,7134,0.45,770,2071,0.3718010622887494,0.815,2437,5063,0.4813351767726644,54,28,1569,1926,1022,2786,3808,1904,1125,454,387,304,1576,8753,327,2013-14
Sacramento Kings,0.341,3026,6766,0.447,491,1475,0.3328813559322034,0.759,2535,5291,0.47911547911547914,28,54,1698,2237,990,2656,3646,1547,1249,587,318,459,1849,8241,-238,2013-14
San Antonio Spurs,0.756,3326,6844,0.486,698,1757,0.3972680705748435,0.785,2628,5087,0.5166109691370159,62,20,1289,1642,762,2786,3548,2064,1180,604,420,379,1495,8639,633,2013-14
Toronto Raptors,0.585,2992,6718,0.445,713,1917,0.37193531559728743,0.782,2279,4801,0.474692772339096,48,34,1608,2055,935,2552,3487,1737,1159,577,343,352,1882,8305,266,2013-14
Utah Jazz,0.305,2951,6652,0.444,543,1577,0.3443246670894103,0.747,2408,5075,0.47448275862068967,25,57,1346,1803,904,2477,3381,1664,1200,570,366,401,1699,7791,-588,2013-14
Washington Wizards,0.537,3177,6920,0.459,647,1704,0.3796948356807512,0.731,2530,5216,0.48504601226993865,44,38,1253,1715,886,2573,3459,1909,1204,668,377,320,1675,8254,104,2013-14
Atlanta Hawks,0.732,3121,6699,0.466,818,2152,0.38011152416356875,0.778,2303,4547,0.506487794149989,60,22,1349,1735,715,2611,3326,2111,1167,744,380,404,1457,8409,445,2014-15
Boston Celtics,0.488,3193,7211,0.443,660,2021,0.32657100445324094,0.754,2533,5190,0.4880539499036609,40,42,1266,1678,910,2685,3595,2009,1133,674,294,431,1738,8312,13,2014-15
Brooklyn Nets,0.463,3069,6804,0.451,541,1633,0.3312921004286589,0.748,2528,5171,0.48888029394701216,38,44,1359,1817,846,2627,3473,1716,1133,576,340,372,1579,8038,-236,2014-15
Charlotte Hornets,0.402,2913,6932,0.42,498,1566,0.31800766283524906,0.748,2415,5366,0.45005590756615726,33,49,1397,1867,820,2793,3613,1654,976,499,448,440,1494,7721,-260,2014-15
Chicago Bulls,0.61,3001,6797,0.442,645,1825,0.35342465753424657,0.783,2356,4972,0.47385358004827033,50,32,1618,2067,959,2792,3751,1781,1145,514,476,443,1495,8265,246,2014-15
Cleveland Cavaliers,0.646,3089,6739,0.458,826,2253,0.36662228140257436,0.751,2263,4486,0.5044583147570219,53,29,1453,1934,911,2612,3523,1814,1171,603,340,368,1510,8457,367,2014-15
Dallas Mavericks,0.61,3255,7036,0.463,732,2082,0.3515850144092219,0.752,2523,4954,0.5092854259184497,50,32,1386,1843,858,2608,3466,1846,1062,663,371,314,1644,8628,238,2014-15
Denver Nuggets,0.366,3099,7158,0.433,660,2032,0.3248031496062992,0.734,2439,5126,0.4758095981271947,30,52,1462,1991,1012,2653,3665,1788,1166,641,367,504,1882,8320,-291,2014-15
Detroit Pistons,0.39,3041,7038,0.432,703,2043,0.3441018110621635,0.703,2338,4995,0.46806806806806805,32,50,1292,1838,1051,2630,3681,1771,1099,623,383,391,1559,8077,-82,2014-15
Golden State Warriors,0.817,3410,7137,0.478,883,2217,0.39828597203428057,0.768,2527,4920,0.5136178861788618,67,15,1313,1709,853,2814,3667,2248,1185,762,496,293,1628,9016,828,2014-15
Houston Rockets,0.683,3032,6832,0.444,933,2680,0.34813432835820896,0.715,2099,4152,0.5055394990366089,56,26,1525,2133,958,2624,3582,1820,1366,777,407,437,1803,8522,282,2014-15
Indiana Pacers,0.463,2998,6824,0.439,612,1740,0.35172413793103446,0.756,2386,5084,0.46931549960660895,38,44,1373,1817,856,2822,3678,1757,1147,505,375,386,1742,7981,23,2014-15
Los Angeles Clippers,0.683,3228,6830,0.473,827,2202,0.37556766575840145,0.71,2401,4628,0.5187986171132238,56,26,1468,2067,784,2711,3495,2031,1012,640,409,245,1749,8751,540,2014-15
Los Angeles Lakers,0.256,3054,7020,0.435,532,1546,0.34411384217335056,0.741,2522,5474,0.4607234198027037,21,61,1433,1935,952,2647,3599,1715,1086,578,366,396,1741,8073,-561,2014-15
Memphis Grizzlies,0.671,3097,6763,0.458,423,1246,0.3394863563402889,0.773,2674,5517,0.4846837049120899,55,27,1445,1869,856,2634,3490,1777,1094,700,347,424,1567,8062,266,2014-15
Miami Heat,0.451,2885,6330,0.456,556,1659,0.3351416515973478,0.741,2329,4671,0.49860843502462,37,45,1438,1940,747,2461,3208,1626,1214,642,372,359,1636,7764,-213,2014-15
Milwaukee Bucks,0.5,3083,6722,0.459,545,1500,0.36333333333333334,0.757,2538,5222,0.4860206817311375,41,41,1312,1734,876,2574,3450,1932,1373,789,403,392,1814,8023,35,2014-15
Minnesota Timberwolves,0.195,2986,6820,0.438,406,1223,0.33197056418642684,0.776,2580,5597,0.4609612292299446,16,66,1638,2110,949,2406,3355,1771,1231,668,327,449,1571,8016,-721,2014-15
New Orleans Pelicans,0.549,3108,6795,0.457,586,1583,0.37018319646241316,0.751,2522,5212,0.4838833461243285,45,37,1345,1790,942,2621,3563,1806,1087,553,510,475,1530,8147,65,2014-15
New York Knicks,0.207,2882,6726,0.428,560,1614,0.3469640644361834,0.769,2322,5112,0.45422535211267606,17,65,1211,1575,867,2443,3310,1746,1206,575,382,353,1768,7535,-764,2014-15
Oklahoma City Thunder,0.549,3184,7119,0.447,632,1864,0.33905579399141633,0.754,2552,5255,0.4856327307326356,45,37,1524,2020,1052,2844,3896,1681,1205,598,454,377,1829,8524,179,2014-15
Orlando Magic,0.305,3076,6792,0.453,554,1598,0.34668335419274093,0.729,2522,5194,0.4855602618405853,25,57,1141,1565,822,2607,3429,1692,1221,647,314,441,1714,7847,-469,2014-15
Philadelphia 76ers,0.22,2765,6777,0.408,692,2160,0.32037037037037036,0.676,2073,4617,0.4489928525016244,18,64,1320,1953,978,2536,3514,1683,1453,789,487,454,1778,7542,-736,2014-15
Phoenix Suns,0.476,3178,7038,0.452,698,2048,0.3408203125,0.76,2480,4990,0.4969939879759519,39,43,1343,1767,896,2643,3539,1659,1238,700,385,337,1744,8397,-74,2014-15
Portland Trail Blazers,0.622,3175,7049,0.45,807,2231,0.3617212012550426,0.801,2368,4818,0.49149024491490245,51,31,1272,1589,879,2881,3760,1799,1117,525,372,297,1494,8429,347,2014-15
Sacramento Kings,0.354,3010,6617,0.455,461,1350,0.3414814814814815,0.762,2549,5267,0.4839567116005316,29,53,1829,2400,895,2728,3623,1667,1333,550,324,508,1696,8310,-304,2014-15
San Antonio Spurs,0.671,3208,6854,0.468,677,1847,0.36654033567948024,0.78,2531,5007,0.5054923107649291,55,27,1368,1754,806,2772,3578,2000,1146,657,444,362,1564,8461,508,2014-15
Toronto Raptors,0.598,3108,6829,0.455,726,2060,0.3524271844660194,0.787,2382,4769,0.49947578108618157,49,33,1585,2014,881,2526,3407,1701,1057,615,357,413,1712,8527,252,2014-15
Utah Jazz,0.463,2900,6492,0.447,610,1781,0.3425042111173498,0.721,2290,4711,0.4860963701974103,38,44,1391,1929,988,2617,3605,1632,1256,623,489,382,1583,7801,18,2014-15
Washington Wizards,0.561,3139,6790,0.462,497,1381,0.3598841419261405,0.742,2642,5409,0.48844518395267145,46,36,1305,1758,862,2801,3663,1969,1233,601,378,350,1707,8080,59,2014-15
Atlanta Hawks,0.585,3168,6923,0.458,815,2326,0.35038693035253654,0.783,2353,4597,0.5118555579725909,48,34,1282,1638,679,2772,3451,2100,1226,747,486,411,1570,8433,296,2015-16
Boston Celtics,0.585,3216,7318,0.439,717,2142,0.33473389355742295,0.788,2499,5176,0.48280525502318394,48,34,1520,1929,950,2733,3683,1981,1127,752,348,450,1796,8669,263,2015-16
Brooklyn Nets,0.256,3136,6920,0.453,531,1508,0.3521220159151194,0.757,2605,5412,0.48133776792313376,21,61,1286,1699,863,2614,3477,1829,1212,627,332,430,1476,8089,-603,2015-16
Charlotte Hornets,0.585,3036,6922,0.439,873,2410,0.3622406639004149,0.79,2163,4512,0.47938829787234044,48,34,1534,1941,734,2869,3603,1778,1029,595,438,448,1487,8479,223,2015-16
Chicago Bulls,0.512,3165,7170,0.441,651,1753,0.37136337706788364,0.787,2514,5417,0.4640945172604763,42,40,1354,1720,907,2889,3796,1870,1141,495,470,465,1545,8335,-121,2015-16
Cleveland Cavaliers,0.695,3171,6888,0.46,880,2428,0.3624382207578254,0.748,2291,4460,0.51367713004484306,57,25,1333,1783,873,2777,3650,1861,1114,551,317,362,1666,8555,492,2015-16
Dallas Mavericks,0.512,3064,6900,0.444,806,2342,0.3441502988898377,0.794,2258,4558,0.4953927161035542,42,40,1454,1831,751,2781,3532,1813,1047,560,306,363,1595,8388,-25,2015-16
Denver Nuggets,0.402,3093,7003,0.442,656,1943,0.3376222336592898,0.766,2437,5060,0.4816205533596838,33,49,1513,1974,941,2718,3659,1858,1202,609,395,517,1723,8355,-254,2015-16
Detroit Pistons,0.537,3111,7087,0.439,740,2148,0.34450651769087526,0.668,2371,4939,0.4800566916379834,44,38,1399,2095,1021,2777,3798,1594,1110,573,304,366,1557,8361,50,2015-16
Golden State Warriors,0.89,3489,7159,0.487,1077,2592,0.41550925925925924,0.763,2412,4567,0.5281366323626012,73,9,1366,1790,816,2972,3788,2373,1245,689,498,336,1701,9421,882,2015-16
Houston Rockets,0.5,3094,6847,0.452,878,2533,0.3466245558626135,0.694,2216,4314,0.5136764024107556,41,41,1671,2407,930,2601,3531,1821,1307,821,430,404,1790,8737,16,2015-16
Indiana Pacers,0.549,3142,6985,0.45,663,1889,0.3509793541556379,0.764,2479,5096,0.48645996860282575,45,37,1430,1872,847,2779,3626,1741,1219,742,391,366,1641,8377,140,2015-16
LA Clippers,0.646,3141,6759,0.465,797,2190,0.3639269406392694,0.692,2344,4569,0.5130225432260889,53,29,1490,2152,721,2727,3448,1873,1063,709,460,259,1746,8569,351,2015-16
Los Angeles Lakers,0.207,2880,6956,0.414,639,2016,0.3169642857142857,0.781,2241,4940,0.4536437246963563,17,65,1583,2028,878,2645,3523,1478,1124,593,337,458,1662,7982,-784,2015-16
Memphis Grizzlies,0.512,3019,6859,0.44,504,1521,0.33136094674556216,0.783,2515,5338,0.4711502435369052,42,40,1584,2024,916,2497,3413,1697,1090,724,350,469,1783,8126,-184,2015-16
Miami Heat,0.585,3150,6697,0.47,498,1480,0.3364864864864865,0.744,2652,5217,0.5083381253594019,48,34,1406,1889,807,2811,3618,1709,1155,553,531,337,1502,8204,135,2015-16
Milwaukee Bucks,0.402,3145,6740,0.467,440,1277,0.3445575567736883,0.747,2705,5463,0.49514918542925135,33,49,1392,1863,858,2559,3417,1895,1247,672,475,462,1695,8122,-343,2015-16
Minnesota Timberwolves,0.354,3095,6668,0.464,455,1347,0.33778767631774315,0.792,2640,5321,0.49614734072542754,29,53,1753,2213,821,2587,3408,1916,1231,656,375,427,1696,8398,-290,2015-16
New Orleans Pelicans,0.366,3153,7040,0.448,702,1951,0.35981547924141466,0.776,2451,5089,0.4816270387109452,30,52,1415,1823,782,2712,3494,1818,1102,633,342,423,1713,8423,-311,2015-16
New York Knicks,0.39,3022,6886,0.439,610,1762,0.34619750283768447,0.805,2412,5124,0.4707259953161593,32,50,1411,1753,850,2788,3638,1682,1099,467,466,343,1616,8065,-224,2015-16
Oklahoma City Thunder,0.671,3372,7082,0.476,678,1945,0.34858611825192803,0.782,2694,5137,0.5244306015183959,55,27,1616,2067,1071,2916,3987,1883,1305,603,487,373,1691,9038,597,2015-16
Orlando Magic,0.427,3242,7120,0.455,636,1818,0.34983498349834985,0.757,2606,5302,0.4915126367408525,35,47,1249,1649,843,2709,3552,1933,1155,673,417,448,1701,8369,-133,2015-16
Philadelphia 76ers,0.122,2970,6887,0.431,764,2255,0.33880266075388027,0.694,2206,4632,0.47625215889464595,10,72,1284,1850,777,2605,3382,1765,1343,680,495,466,1780,7988,-839,2015-16
Phoenix Suns,0.28,3051,7018,0.435,738,2118,0.34844192634560905,0.751,2313,4900,0.4720408163265306,23,59,1431,1905,943,2733,3676,1701,1410,632,313,449,1858,8271,-546,2015-16
Portland Trail Blazers,0.537,3167,7040,0.45,864,2336,0.3698630136986301,0.754,2303,4704,0.4895833333333333,44,38,1424,1889,948,2782,3730,1748,1200,562,380,424,1782,8622,68,2015-16
Sacramento Kings,0.402,3283,7083,0.464,660,1839,0.35889070146818924,0.725,2623,5244,0.5001906941266209,33,49,1514,2089,868,2760,3628,2009,1326,733,368,437,1676,8740,-203,2015-16
San Antonio Spurs,0.817,3289,6797,0.484,570,1518,0.37549407114624506,0.803,2719,5279,0.5150596703921198,67,15,1342,1672,770,2831,3601,2010,1071,677,485,317,1433,8490,872,2015-16
Toronto Raptors,0.683,3006,6669,0.451,708,1915,0.3697127937336815,0.777,2298,4754,0.48338241480858224,56,26,1702,2190,836,2724,3560,1536,1073,636,449,442,1610,8422,369,2015-16
Utah Jazz,0.488,2957,6593,0.449,694,1956,0.35480572597137017,0.744,2263,4637,0.48803105456113866,40,42,1402,1885,880,2665,3545,1554,1224,631,425,385,1655,8010,147,2015-16
Washington Wizards,0.5,3238,7033,0.46,709,1983,0.35753908219868885,0.73,2529,5050,0.5007920792079208,41,41,1349,1849,743,2688,3431,2005,1186,708,323,356,1708,8534,-41,2015-16
Atlanta Hawks,0.524,3123,6918,0.451,729,2137,0.341132428638278,0.728,2394,4781,0.5007320644216691,43,39,1484,2039,842,2793,3635,1938,1294,672,397,424,1491,8459,-70,2016-17
Boston Celtics,0.646,3168,6977,0.454,985,2741,0.3593578985771616,0.807,2183,4236,0.5153446647780925,53,29,1536,1903,743,2698,3441,2069,1088,617,340,425,1686,8857,216,2016-17
Brooklyn Nets,0.244,3102,6987,0.444,877,2591,0.3384793516016982,0.788,2225,4396,0.5061419472247498,20,62,1592,2020,721,2879,3600,1756,1356,593,387,457,1726,8673,-552,2016-17
Charlotte Hornets,0.439,3093,7000,0.442,824,2347,0.3510864933958245,0.815,2269,4653,0.4876423812594025,36,46,1591,1953,721,2853,3574,1891,942,571,390,450,1360,8601,16,2016-17
Chicago Bulls,0.5,3169,7141,0.444,623,1831,0.3402512288367013,0.798,2546,5310,0.47947269303201506,41,41,1474,1848,999,2797,3796,1851,1112,643,393,378,1455,8435,35,2016-17
Cleveland Cavaliers,0.622,3275,6963,0.47,1067,2779,0.3839510615329255,0.748,2208,4184,0.5277246653919694,51,31,1431,1913,766,2821,3587,1858,1121,539,327,349,1486,9048,261,2016-17
Dallas Mavericks,0.402,2968,6750,0.44,878,2473,0.35503437120905784,0.801,2090,4277,0.48866027589431843,33,49,1215,1516,647,2516,3163,1705,972,614,307,280,1567,8029,-240,2016-17
Denver Nuggets,0.488,3377,7194,0.469,870,2365,0.3678646934460888,0.774,2507,4829,0.5191551045765169,40,42,1537,1986,966,2837,3803,2077,1226,568,323,404,1567,9161,42,2016-17
Detroit Pistons,0.451,3269,7282,0.449,631,1915,0.32950391644908616,0.719,2638,5367,0.49152226569778273,37,45,1140,1586,908,2838,3746,1732,973,574,310,339,1467,8309,-92,2016-17
Golden State Warriors,0.817,3532,7140,0.495,982,2562,0.3832943013270882,0.788,2550,4578,0.5570117955439057,67,15,1457,1850,770,2873,3643,2491,1211,785,555,313,1585,9503,954,2016-17
Houston Rockets,0.671,3305,7152,0.462,1181,3306,0.3572292800967937,0.766,2124,3846,0.5522620904836193,55,27,1667,2177,892,2746,3638,2070,1240,670,352,409,1634,9458,473,2016-17
Indiana Pacers,0.512,3221,6931,0.465,709,1885,0.37612732095490714,0.81,2512,5046,0.49782005548949665,42,40,1467,1811,742,2702,3444,1844,1130,669,409,407,1597,8618,-18,2016-17
LA Clippers,0.622,3242,6820,0.475,841,2245,0.37461024498886414,0.745,2401,4575,0.524808743169399,51,31,1586,2128,738,2790,3528,1848,1062,612,347,258,1626,8911,352,2016-17
Los Angeles Lakers,0.317,3224,7164,0.45,730,2110,0.3459715639810427,0.754,2494,5054,0.4934705184012663,26,56,1397,1853,933,2636,3569,1716,1243,674,320,440,1698,8575,-564,2016-17
Memphis Grizzlies,0.524,2984,6854,0.435,767,2169,0.35361917934532044,0.784,2217,4685,0.4732123799359658,43,39,1504,1918,886,2621,3507,1744,1059,653,344,410,1840,8239,40,2016-17
Miami Heat,0.5,3202,7037,0.455,808,2213,0.36511522819701764,0.706,2394,4824,0.4962686567164179,41,41,1248,1768,872,2705,3577,1742,1102,588,469,398,1680,8460,87,2016-17
Milwaukee Bucks,0.512,3182,6715,0.474,720,1946,0.3699897225077081,0.768,2462,4769,0.5162507863283707,42,40,1413,1839,723,2589,3312,1984,1145,666,436,375,1660,8497,-15,2016-17
Minnesota Timberwolves,0.378,3235,6922,0.467,601,1723,0.3488102147417295,0.799,2634,5199,0.5066358915175996,31,51,1586,1986,938,2540,3478,1940,1150,654,370,413,1646,8657,-91,2016-17
New Orleans Pelicans,0.415,3210,7130,0.45,768,2196,0.34972677595628415,0.75,2442,4934,0.4949331171463316,34,48,1368,1825,703,2879,3582,1869,1054,638,453,348,1490,8556,-172,2016-17
New York Knicks,0.378,3244,7256,0.447,704,2022,0.34817012858555885,0.788,2540,5234,0.4852884982804738,31,51,1364,1731,983,2723,3706,1786,1139,581,455,377,1668,8556,-301,2016-17
Oklahoma City Thunder,0.573,3237,7169,0.452,692,2116,0.3270321361058601,0.745,2545,5053,0.5036611913714625,47,35,1575,2113,1002,2821,3823,1721,1230,648,408,450,1715,8741,62,2016-17
Orlando Magic,0.354,3139,7133,0.44,701,2139,0.3277232351566152,0.747,2438,4994,0.4881858229875851,29,53,1309,1753,807,2734,3541,1820,1091,580,396,419,1584,8288,-539,2016-17
Philadelphia 76ers,0.341,3088,6992,0.442,831,2443,0.3401555464592714,0.771,2257,4549,0.4961530006594856,28,54,1393,1806,807,2706,3513,1949,1366,692,420,446,1793,8400,-467,2016-17
Phoenix Suns,0.293,3270,7260,0.45,615,1854,0.33171521035598706,0.776,2655,5406,0.4911209766925638,24,58,1676,2159,976,2712,3688,1604,1265,673,399,435,2030,8831,-462,2016-17
Portland Trail Blazers,0.5,3243,7059,0.459,852,2272,0.375,0.78,2391,4787,0.4994777522456653,41,41,1513,1940,830,2750,3580,1733,1126,574,408,431,1736,8851,-43,2016-17
Sacramento Kings,0.39,3105,6734,0.461,737,1960,0.3760204081632653,0.775,2368,4774,0.49602010892333476,32,50,1483,1913,715,2652,3367,1844,1201,627,324,420,1667,8430,-318,2016-17
San Antonio Spurs,0.744,3222,6864,0.469,753,1927,0.3907628437986507,0.797,2469,4937,0.5001012760785902,61,21,1440,1806,821,2777,3598,1954,1101,655,484,333,1498,8637,590,2016-17
Toronto Raptors,0.622,3211,6918,0.464,725,1996,0.3632264529058116,0.796,2486,4922,0.5050792360828932,51,31,1615,2028,871,2676,3547,1517,1041,677,400,392,1708,8762,345,2016-17
Utah Jazz,0.622,3033,6515,0.466,791,2128,0.3717105263157895,0.747,2242,4387,0.5110553909277411,51,31,1401,1875,771,2774,3545,1651,1118,550,410,312,1545,8258,323,2016-17
Washington Wizards,0.598,3388,7137,0.475,756,2030,0.3724137931034483,0.784,2632,5107,0.5153710593303309,49,33,1421,1812,843,2671,3514,1956,1162,693,336,377,1745,8953,148,2016-17
Atlanta Hawks,0.293,3130,7015,0.446,917,2544,0.3604559748427673,0.785,2213,4471,0.49496756877656006,24,58,1298,1654,743,2693,3436,1946,1274,638,348,453,1606,8475,-447,2017-18
Boston Celtics,0.671,3141,6975,0.45,939,2492,0.37680577849117175,0.771,2202,4483,0.4911889359803703,55,27,1308,1697,767,2878,3645,1842,1148,604,373,364,1618,8529,294,2017-18
Brooklyn Nets,0.341,3136,7114,0.441,1041,2924,0.35601915184678523,0.772,2095,4190,0.5,28,54,1428,1850,792,2852,3644,1941,1245,512,390,450,1688,8741,-307,2017-18
Charlotte Hornets,0.439,3197,7106,0.45,824,2233,0.3690103000447828,0.747,2373,4873,0.48696901292838085,36,46,1656,2216,827,2901,3728,1770,1041,559,373,404,1409,8874,21,2017-18
Chicago Bulls,0.329,3170,7285,0.435,906,2549,0.355433503334641,0.759,2264,4736,0.4780405405405405,27,55,1194,1574,790,2872,3662,1923,1147,626,289,423,1571,8440,-577,2017-18
Cleveland Cavaliers,0.61,3311,6950,0.476,981,2636,0.37215477996965096,0.779,2330,4314,0.5401019935095039,50,32,1488,1909,694,2761,3455,1916,1126,582,312,340,1524,9091,77,2017-18
Dallas Mavericks,0.293,3128,7042,0.444,967,2688,0.35974702380952384,0.763,2161,4354,0.49632521819016995,24,58,1167,1530,666,2717,3383,1858,1007,578,310,369,1578,8390,-249,2017-18
Denver Nuggets,0.561,3338,7102,0.47,940,2536,0.37066246056782337,0.767,2398,4566,0.5251861585632939,46,36,1404,1830,902,2748,3650,2059,1226,627,404,391,1533,9020,121,2017-18
Detroit Pistons,0.476,3208,7129,0.45,886,2373,0.37336704593341763,0.745,2322,4756,0.48822539949537425,39,43,1207,1621,830,2756,3586,1868,1102,628,317,398,1508,8509,-12,2017-18
Golden State Warriors,0.707,3509,6979,0.503,926,2369,0.39088222878851836,0.815,2583,4610,0.5603036876355748,58,24,1360,1668,691,2877,3568,2402,1265,656,612,300,1607,9304,490,2017-18
Houston Rockets,0.793,3174,6906,0.46,1256,3470,0.3619596541786744,0.781,1918,3436,0.5582072176949942,65,17,1609,2061,739,2825,3564,1767,1135,699,392,363,1597,9213,695,2017-18
Indiana Pacers,0.585,3345,7083,0.472,741,2010,0.3686567164179104,0.779,2604,5073,0.5133057362507392,48,34,1225,1573,788,2684,3472,1819,1088,721,340,428,1544,8656,113,2017-18
LA Clippers,0.512,3302,7004,0.471,777,2196,0.35382513661202186,0.743,2525,4808,0.5251663893510815,42,40,1556,2095,832,2766,3598,1832,1204,628,372,462,1638,8937,3,2017-18
Los Angeles Lakers,0.427,3338,7248,0.461,822,2384,0.3447986577181208,0.714,2516,4864,0.5172697368421053,35,47,1364,1910,876,2927,3803,1949,1295,633,388,447,1736,8862,-127,2017-18
Memphis Grizzlies,0.268,3013,6788,0.444,758,2152,0.35223048327137546,0.786,2255,4636,0.4864106988783434,22,60,1361,1732,779,2544,3323,1767,1227,613,396,421,1900,8145,-509,2017-18
Miami Heat,0.537,3184,6997,0.455,903,2506,0.36033519553072624,0.755,2281,4491,0.5079046982854598,44,38,1209,1601,763,2801,3564,1862,1178,620,437,378,1648,8480,39,2017-18
Milwaukee Bucks,0.537,3257,6807,0.478,718,2024,0.3547430830039526,0.783,2539,4783,0.5308383859502405,44,38,1499,1915,688,2579,3267,1905,1135,722,443,366,1752,8731,-25,2017-18
Minnesota Timberwolves,0.573,3365,7063,0.476,658,1845,0.35663956639566397,0.804,2707,5218,0.5187811422000767,47,35,1592,1980,848,2593,3441,1861,1021,689,345,382,1495,8980,183,2017-18
New Orleans Pelicans,0.585,3500,7241,0.483,837,2312,0.3620242214532872,0.772,2663,4929,0.5402718604179346,48,34,1324,1716,712,2923,3635,2195,1223,657,485,344,1570,9161,107,2017-18
New York Knicks,0.354,3334,7193,0.464,673,1914,0.351619644723093,0.787,2661,5279,0.5040727410494412,29,53,1225,1557,859,2752,3611,1912,1208,552,421,389,1682,8566,-292,2017-18
Oklahoma City Thunder,0.585,3271,7221,0.453,881,2491,0.35367322360497794,0.716,2390,4730,0.5052854122621564,48,34,1421,1985,1024,2671,3695,1750,1147,743,412,377,1653,8844,280,2017-18
Orlando Magic,0.305,3182,7042,0.452,844,2405,0.35093555093555096,0.757,2338,4637,0.5042053051541945,25,57,1271,1678,722,2692,3414,1921,1192,622,400,402,1579,8479,-395,2017-18
Philadelphia 76ers,0.634,3349,7098,0.472,901,2445,0.3685071574642127,0.752,2448,4653,0.5261121856866537,52,30,1405,1868,893,2996,3889,2221,1353,682,420,417,1811,9004,369,2017-18
Phoenix Suns,0.256,3153,7141,0.442,763,2286,0.3337707786526684,0.741,2390,4855,0.4922760041194645,21,61,1453,1962,842,2776,3618,1743,1289,569,370,488,1807,8522,-768,2017-18
Portland Trail Blazers,0.598,3222,7132,0.452,845,2308,0.36611785095320626,0.8,2377,4824,0.49274461028192373,49,33,1372,1715,835,2893,3728,1599,1109,573,423,418,1599,8661,213,2017-18
Sacramento Kings,0.329,3179,7063,0.45,738,1967,0.3751906456532791,0.735,2441,5096,0.4790031397174254,27,55,1008,1371,776,2578,3354,1768,1125,643,340,389,1639,8104,-573,2017-18
San Antonio Spurs,0.573,3202,6999,0.457,696,1977,0.3520485584218513,0.772,2506,5022,0.49900438072481085,47,35,1324,1715,849,2777,3626,1868,1078,628,460,318,1408,8424,237,2017-18
Toronto Raptors,0.72,3383,7169,0.472,968,2705,0.3578558225508318,0.794,2415,4464,0.540994623655914,59,23,1422,1790,800,2807,3607,1995,1095,626,500,401,1783,9156,638,2017-18
Utah Jazz,0.585,3139,6797,0.462,887,2425,0.36577319587628865,0.779,2252,4372,0.515096065873742,48,34,1375,1766,740,2807,3547,1839,1205,708,420,380,1608,8540,353,2017-18
Washington Wizards,0.524,3275,7018,0.467,814,2173,0.3745973308789692,0.772,2461,4845,0.5079463364293085,43,39,1378,1786,823,2713,3536,2065,1196,645,353,383,1746,8742,48,2017-18
Atlanta Hawks,0.354,3392,7524,0.451,1067,3034,0.35168094924192483,0.752,2325,4490,0.5178173719376392,29,53,1443,1918,955,2825,3780,2118,1397,675,419,448,1932,9294,-494,2018-19
Boston Celtics,0.598,3451,7423,0.465,1032,2829,0.3647932131495228,0.802,2419,4594,0.5265563778841967,49,33,1282,1598,804,2849,3653,2155,1052,706,435,317,1669,9216,364,2018-19
Brooklyn Nets,0.512,3301,7358,0.449,1047,2965,0.35311973018549747,0.745,2254,4393,0.5130890052356021,42,40,1555,2088,900,2919,3819,1954,1236,539,339,432,1763,9204,-6,2018-19
Charlotte Hornets,0.476,3297,7362,0.448,977,2783,0.3510600071864894,0.797,2320,4579,0.5066608429788163,39,43,1510,1895,814,2778,3592,1905,1001,591,405,492,1550,9081,-90,2018-19
Chicago Bulls,0.268,3266,7205,0.453,745,2123,0.3509185115402732,0.783,2521,5082,0.49606454151908697,22,60,1328,1695,718,2799,3517,1796,1159,603,351,473,1663,8605,-690,2018-19
Cleveland Cavaliers,0.232,3189,7184,0.444,847,2388,0.3546901172529313,0.792,2342,4796,0.4883236030025021,19,63,1342,1694,879,2619,3498,1698,1106,534,195,459,1642,8567,-788,2018-19
Dallas Mavericks,0.402,3182,7122,0.447,1022,3002,0.34043970686209196,0.742,2160,4120,0.5242718446601942,33,49,1541,2076,832,2884,3716,1918,1167,533,351,368,1650,8927,-105,2018-19
Denver Nuggets,0.659,3439,7384,0.466,903,2571,0.35122520420070014,0.755,2536,4813,0.5269062954498234,54,28,1294,1714,972,2832,3804,2245,1102,634,363,407,1644,9075,324,2018-19
Detroit Pistons,0.5,3185,7238,0.44,993,2854,0.3479327259985985,0.747,2192,4384,0.5,41,41,1415,1893,936,2752,3688,1845,1135,569,331,419,1811,8778,-20,2018-19
Golden State Warriors,0.695,3612,7361,0.491,1087,2824,0.38491501416430596,0.801,2525,4537,0.5565351553890235,57,25,1339,1672,797,2990,3787,2413,1169,625,525,295,1757,9650,530,2018-19
Houston Rockets,0.646,3218,7163,0.449,1323,3721,0.3555495834453104,0.791,1895,3442,0.5505520046484602,53,29,1582,2001,836,2613,3449,1741,1094,700,405,369,1803,9341,391,2018-19
Indiana Pacers,0.585,3390,7135,0.475,779,2081,0.3743392599711677,0.752,2611,5054,0.5166204986149584,48,34,1298,1727,762,2766,3528,2128,1122,713,404,425,1594,8857,273,2018-19
LA Clippers,0.585,3384,7178,0.471,821,2118,0.3876298394711992,0.792,2563,5060,0.5065217391304347,48,34,1853,2340,796,2936,3732,1970,1193,561,385,498,1913,9442,70,2018-19
Los Angeles Lakers,0.451,3491,7425,0.47,847,2541,0.3333333333333333,0.699,2644,4884,0.5413595413595413,37,45,1336,1910,835,2985,3820,2096,1284,618,440,421,1701,9165,-141,2018-19
Memphis Grizzlies,0.402,3113,6924,0.45,811,2368,0.3424831081081081,0.772,2302,4556,0.5052677787532923,33,49,1453,1882,723,2703,3426,1963,1147,684,448,402,1801,8490,-213,2018-19
Miami Heat,0.476,3251,7218,0.45,928,2658,0.3491346877351392,0.695,2323,4560,0.5094298245614035,39,43,1238,1782,921,2879,3800,1991,1208,627,448,389,1712,8668,-19,2018-19
Milwaukee Bucks,0.732,3555,7471,0.476,1105,3134,0.35258455647734527,0.773,2450,4337,0.564906617477519,60,22,1471,1904,762,3316,4078,2136,1137,615,486,395,1608,9686,727,2018-19
Minnesota Timberwolves,0.439,3413,7483,0.456,827,2357,0.3508697496817989,0.787,2586,5126,0.5044869293796332,36,46,1570,1995,923,2750,3673,2018,1074,683,411,455,1664,9223,-123,2018-19
New Orleans Pelicans,0.402,3581,7563,0.473,842,2449,0.34381380155165375,0.761,2739,5114,0.53558858036761825,33,49,1462,1921,909,2969,3878,2216,1215,610,441,445,1732,9466,-109,2018-19
New York Knicks,0.207,3134,7241,0.433,823,2421,0.3399421726559273,0.759,2311,4820,0.4794605809128631,17,65,1484,1956,857,2811,3668,1646,1151,557,422,458,1713,8575,-755,2018-19
Oklahoma City Thunder,0.598,3497,7706,0.454,932,2677,0.3481509152035861,0.713,2565,5029,0.5100417578047326,49,33,1461,2049,1031,2911,3942,1917,1145,766,425,415,1839,9387,279,2018-19
Orlando Magic,0.512,3316,7307,0.454,937,2633,0.35586783137105965,0.782,2379,4674,0.5089858793324775,42,40,1231,1575,822,2902,3724,2095,1082,543,445,362,1526,8800,58,2018-19
Philadelphia 76ers,0.622,3407,7233,0.471,889,2474,0.3593371059013743,0.771,2518,4759,0.5291027526791343,51,31,1742,2258,892,3025,3917,2207,1223,606,432,336,1745,9445,221,2018-19
Phoenix Suns,0.232,3289,7164,0.459,790,2400,0.32916666666666666,0.779,2499,4764,0.52455919395466,19,63,1447,1858,748,2563,3311,1957,1279,735,418,411,1932,8815,-766,2018-19
Portland Trail Blazers,0.646,3470,7427,0.467,904,2520,0.35873015873015873,0.814,2566,4907,0.5229264316282861,53,29,1558,1914,967,2968,3935,1887,1135,546,413,420,1669,9402,344,2018-19
Sacramento Kings,0.476,3541,7637,0.464,927,2455,0.3775967413441955,0.726,2614,5182,0.5044384407564647,39,43,1354,1865,906,2819,3725,2083,1095,679,363,420,1751,9363,-92,2018-19
San Antonio Spurs,0.585,3468,7248,0.478,812,2071,0.3920811202317721,0.819,2656,5177,0.5130384392505312,48,34,1408,1720,757,2910,3667,2013,992,501,386,332,1487,9156,138,2018-19
Toronto Raptors,0.707,3460,7305,0.474,1015,2771,0.36629375676651027,0.804,2445,4534,0.539258932509925,58,24,1449,1803,786,2920,3706,2085,1150,680,437,368,1724,9384,499,2018-19
Utah Jazz,0.61,3314,7082,0.468,993,2789,0.3560415919684475,0.736,2321,4293,0.5406475658047986,50,32,1540,2092,820,2981,3801,2133,1240,663,483,376,1728,9161,431,2018-19
Washington Wizards,0.39,3456,7387,0.468,930,2731,0.34053460270963015,0.768,2526,4656,0.5425257731958762,32,50,1508,1963,794,2679,3473,2154,1154,683,379,378,1701,9350,-238,2018-19
