team,season,points_scored,points_allowed,wins,losses,ties,off_total_yards_gained,off_n_pass_touchdowns,off_n_run_touchdowns,off_n_touchdowns,off_pass_or_run_plays,off_n_sacks_allowed,off_n_qb_hits_allowed,off_n_fumbles_lost,off_n_tackled_for_loss,off_n_interceptions_thrown,def_total_yards_allowed,def_n_pass_touchdowns,def_n_run_touchdowns,def_n_touchdowns,def_pass_or_run_plays,def_n_sacks,def_n_qb_hits,def_n_fumbles_forced,def_n_tackles_for_loss,def_n_interceptions,off_pass_completion_perc,off_pass_plays,off_pass_total_yards_gained,off_run_plays,off_run_total_yards_gained,def_pass_completion_perc,def_pass_plays,def_pass_total_yards_gained,def_run_plays,def_run_total_yards_gained,score_differential,division
PIT,2009,368,324,9,7,0,5955,28,10,38,994,50,71,9,42,11,4900,22,7,29,957,46,63,10,34,12,0.6041308089500861,581,4148,413,1807,0.5396290050590219,593,3452,364,1448,44,AFC North
PIT,2010,375,232,12,4,0,5536,22,15,37,971,43,66,8,43,7,4438,15,5,20,963,47,68,10,30,20,0.5831702544031311,511,3600,460,1936,0.5707547169811321,636,3427,327,1011,143,AFC North
PIT,2011,325,227,12,4,0,5970,21,13,34,996,42,71,13,39,14,4353,15,7,22,957,35,66,3,33,11,0.5899653979238755,578,4054,418,1916,0.5160714285714286,560,2751,397,1602,98,AFC North
PIT,2012,336,314,8,8,0,5339,26,9,35,1007,37,62,15,42,14,4430,19,9,28,936,37,64,9,36,10,0.5863787375415282,602,3778,405,1561,0.5368043087971275,557,2965,379,1465,22,AFC North
PIT,2013,379,370,8,8,0,4991,28,9,37,989,42,57,10,35,12,4967,20,18,38,1007,34,64,10,24,10,0.6112026359143328,607,3692,382,1299,0.5454545454545454,594,3228,413,1739,9,AFC North
PIT,2014,436,368,11,5,0,6586,33,10,43,1043,34,61,10,37,10,5662,30,9,39,935,33,77,9,31,11,0.6431924882629108,639,4818,404,1768,0.6104347826086957,575,4057,360,1605,68,AFC North
PIT,2015,423,319,10,6,0,6356,26,16,42,999,33,52,4,38,21,5823,29,6,35,1038,48,75,10,38,14,0.6196513470681458,631,4612,368,1744,0.6036036036036037,666,4352,372,1471,104,AFC North
PIT,2016,399,327,11,5,0,5979,33,13,46,1016,21,55,4,26,15,5489,20,15,35,989,38,81,8,41,9,0.612540192926045,622,4203,394,1776,0.6096,625,3884,364,1605,72,AFC North
PIT,2017,406,308,13,3,0,6088,29,12,41,1029,24,58,4,36,13,4920,20,14,34,932,56,103,6,45,16,0.6290849673202614,612,4392,417,1696,0.5390199637023594,551,3219,381,1701,98,AFC North
PIT,2018,428,360,9,6,1,6478,35,16,51,1043,24,70,9,29,16,5248,27,13,40,977,52,111,6,33,7,0.6446629213483146,712,5016,331,1462,0.5857605177993528,618,3699,359,1549,68,AFC North
CLE,2009,245,375,5,11,0,4170,11,10,21,964,30,53,13,41,16,6240,22,15,37,1046,40,82,6,28,9,0.4669509594882729,469,2076,495,2094,0.566003616636528,553,3909,493,2331,-130,AFC North
CLE,2010,271,332,5,11,0,4639,13,13,26,908,35,54,10,27,16,5615,26,7,33,1021,29,67,8,22,19,0.5818540433925049,507,2978,401,1661,0.5800376647834274,531,3531,490,2084,-61,AFC North
CLE,2011,218,307,4,12,0,4631,16,4,20,1009,40,78,5,30,12,5332,16,12,28,1017,31,52,11,45,9,0.5298013245033113,604,3088,405,1543,0.5321285140562249,498,2962,519,2370,-89,AFC North
CLE,2012,302,368,5,11,0,5035,16,12,28,986,36,75,5,36,17,5836,27,14,41,1073,38,63,12,27,17,0.5503355704697986,596,3435,390,1600,0.5990491283676703,631,3925,442,1911,-66,AFC North
CLE,2013,308,406,4,12,0,4655,26,4,30,1065,50,110,7,33,19,4721,29,13,42,1085,40,76,6,42,14,0.5242047026279392,723,3421,342,1234,0.5636645962732919,644,3123,441,1598,-98,AFC North
CLE,2014,299,337,7,9,0,5199,12,17,29,1000,30,76,6,64,15,5859,22,13,35,1097,30,65,5,34,20,0.5207547169811321,530,3485,470,1714,0.5518945634266886,607,3587,490,2272,-38,AFC North
CLE,2015,278,432,3,13,0,5323,20,5,25,1036,53,96,15,47,12,6085,34,11,45,983,29,60,11,39,11,0.5612708018154312,661,3786,375,1537,0.5974025974025974,539,4016,444,2069,-154,AFC North
CLE,2016,264,452,1,15,0,4982,15,13,28,979,66,123,11,46,11,6295,36,18,54,1053,26,68,2,32,10,0.5356576862123613,631,3268,348,1714,0.6130742049469965,566,4000,487,2295,-188,AFC North
CLE,2017,234,410,0,16,0,4946,15,11,26,1001,50,120,11,30,25,5254,28,14,42,1005,34,68,6,75,7,0.5040387722132472,619,3228,382,1718,0.644524236983842,557,3656,448,1598,-176,AFC North
CLE,2018,359,392,7,8,1,5920,29,15,44,1014,38,69,6,43,17,6305,21,20,41,1106,37,83,14,52,14,0.5749185667752443,614,4011,400,1909,0.5972644376899696,658,4129,448,2176,-33,AFC North
NO,2009,510,341,13,3,0,6476,34,21,55,1014,21,47,14,36,12,5730,15,19,34,1028,36,77,9,39,23,0.6725978647686833,562,4346,452,2130,0.55,600,3763,428,1967,169,NFC South
NO,2010,384,307,11,5,0,5986,33,9,42,1048,26,60,7,33,22,4913,13,13,26,939,33,64,13,39,9,0.6612903225806451,682,4455,366,1531,0.5806451612903226,527,3107,412,1806,77,NFC South
NO,2011,547,339,13,3,0,7798,49,16,65,1134,27,54,5,31,13,6205,24,14,38,1029,33,75,7,31,8,0.6964539007092199,705,5643,429,2155,0.563338301043219,671,4425,358,1780,208,NFC South
NO,2012,461,454,7,9,0,6589,43,10,53,1047,26,53,4,37,18,7062,31,18,49,1069,28,71,10,46,13,0.613933236574746,689,4997,358,1592,0.593900481540931,623,4690,446,2372,7,NFC South
NO,2013,414,304,11,5,0,6392,39,10,49,1048,38,72,3,42,11,4899,20,11,31,931,49,91,8,41,12,0.6510263929618768,682,4893,366,1499,0.5537340619307832,549,3105,382,1794,110,NFC South
NO,2014,401,424,7,9,0,6591,33,16,49,1080,30,75,12,33,16,6162,26,17,43,1011,34,60,5,40,12,0.6676427525622255,683,4764,397,1827,0.5889464594127807,579,4025,432,2137,-23,NFC South
NO,2015,408,476,7,9,0,6485,32,16,48,1079,32,72,8,39,11,6640,45,12,57,986,31,58,12,33,8,0.660458452722063,698,4978,381,1507,0.6480836236933798,574,4548,412,2092,-68,NFC South
NO,2016,469,454,7,9,0,6832,38,17,55,1089,27,65,8,24,15,6024,27,19,46,991,30,88,12,37,7,0.6801152737752162,694,5073,395,1759,0.6206896551724138,609,4384,382,1640,15,NFC South
NO,2017,448,326,11,5,0,6287,23,23,46,977,20,54,8,31,8,5395,22,11,33,990,42,75,4,43,18,0.6992753623188406,552,4193,425,2094,0.5557432432432432,592,3599,398,1796,122,NFC South
NO,2018,504,353,13,3,0,6100,33,26,59,989,20,50,9,28,6,5602,30,12,42,968,49,96,12,38,12,0.7068645640074211,539,4044,450,2056,0.617363344051447,622,4312,346,1290,151,NFC South
TB,2009,244,400,3,13,0,4611,18,5,23,954,32,82,5,37,27,5868,28,16,44,1018,28,75,8,40,17,0.5054151624548736,554,2977,400,1634,0.5984095427435387,503,3318,515,2550,-156,NFC South
TB,2010,341,318,10,6,0,5373,26,9,35,945,30,65,10,37,5,5351,23,12,35,977,26,51,7,43,18,0.5862068965517241,522,3361,423,2012,0.5661764705882353,544,3233,433,2118,23,NFC South
TB,2011,287,494,4,12,0,5117,17,9,26,952,32,54,13,37,22,6329,30,26,56,983,23,43,10,65,13,0.5934959349593496,615,3650,337,1467,0.6007984031936128,501,3814,482,2515,-207,NFC South
TB,2012,389,394,7,9,0,5846,27,13,40,998,25,57,3,40,15,6100,30,13,43,1018,28,57,6,79,17,0.5271186440677966,590,3989,408,1857,0.6298003072196621,651,4753,367,1347,-5,NFC South
TB,2013,288,389,4,12,0,4465,22,6,28,966,47,70,6,45,12,5591,30,10,40,988,35,77,7,58,19,0.5243243243243243,555,2820,411,1645,0.612565445026178,573,3803,415,1788,-101,NFC South
TB,2014,277,410,2,14,0,4672,21,7,28,929,52,112,12,41,20,5917,28,15,43,1049,35,65,10,61,14,0.5225694444444444,576,3297,353,1375,0.6504201680672269,595,4092,454,1825,-133,NFC South
TB,2015,342,417,6,10,0,6031,22,12,34,998,27,104,11,53,14,5468,31,12,43,1023,38,80,12,48,11,0.5621621621621622,555,3854,443,2177,0.6551126516464472,577,3840,446,1628,-75,NFC South
TB,2016,354,369,9,7,0,5570,29,8,37,1054,36,96,9,53,17,5904,24,15,39,1002,38,75,10,37,15,0.5753646677471637,617,3931,437,1639,0.5948717948717949,585,4018,417,1886,-15,NFC South
TB,2017,335,382,5,11,0,5825,26,8,34,1028,39,92,13,34,13,6065,22,17,39,993,22,70,9,38,10,0.5887850467289719,642,4370,386,1455,0.654320987654321,567,4169,426,1896,-47,NFC South
TB,2018,396,464,5,11,0,6659,36,11,47,1046,41,108,9,38,24,6162,34,19,53,974,38,89,6,48,9,0.6126126126126126,666,5127,380,1532,0.680140597539543,569,4153,405,2009,-68,NFC South
HOU,2009,388,333,9,7,0,6149,29,13,42,1019,26,90,11,38,16,5212,19,17,36,957,28,77,10,47,10,0.6498371335504886,614,4652,405,1497,0.6035087719298246,570,3487,387,1725,55,AFC South
HOU,2010,390,427,6,10,0,6195,24,20,44,1015,32,70,6,39,11,6052,33,16,49,992,30,86,5,41,13,0.6073211314475874,601,4145,414,2050,0.6167247386759582,574,4280,418,1772,-37,AFC South
HOU,2011,381,278,10,6,0,5970,20,18,38,1027,33,60,11,53,9,4582,18,8,26,952,44,101,9,34,16,0.5841784989858012,493,3506,534,2464,0.4819277108433735,581,3039,371,1543,103,AFC South
HOU,2012,416,331,12,4,0,6043,22,20,42,1073,28,71,4,54,13,5185,29,5,34,1000,44,102,14,46,12,0.6092943201376936,581,3830,492,2213,0.49838187702265374,618,3609,382,1576,85,AFC South
HOU,2013,276,428,2,14,0,5559,19,7,26,1083,42,105,8,36,22,5100,29,11,40,952,32,98,4,46,6,0.554559043348281,669,3813,414,1746,0.5583657587548638,514,3125,438,1975,-152,AFC South
HOU,2014,372,307,9,7,0,5526,22,12,34,1042,28,77,11,55,13,5586,28,6,34,1060,37,109,12,50,20,0.5784313725490197,510,3340,532,2186,0.557427258805513,653,3897,407,1689,65,AFC South
HOU,2015,339,313,9,7,0,5591,29,7,36,1105,36,76,8,41,11,4977,24,10,34,969,44,93,8,45,14,0.549079754601227,652,3835,453,1756,0.5478991596638656,595,3367,374,1610,26,AFC South
HOU,2016,279,328,9,7,0,5052,15,9,24,1052,32,89,5,34,14,4832,20,13,33,942,31,82,6,43,11,0.5707236842105263,608,3176,444,1876,0.575812274368231,554,3228,388,1604,-49,AFC South
HOU,2017,338,436,4,12,0,5125,28,8,36,1022,54,106,11,40,16,5570,30,14,44,948,32,66,4,52,9,0.5190972222222222,576,3278,446,1847,0.6068052930056711,529,3801,419,1769,-98,AFC South
HOU,2018,402,316,11,5,0,5812,26,12,38,1025,62,124,6,51,9,5497,28,8,36,1013,43,86,11,43,14,0.6127886323268206,563,3781,462,2031,0.608214849921011,633,4169,380,1328,86,AFC South
IND,2009,416,307,14,2,0,5826,34,16,50,962,13,40,4,42,16,5438,19,10,29,1073,34,73,9,24,15,0.659016393442623,610,4515,352,1311,0.6078431372549019,612,3405,461,2033,109,AFC South
IND,2010,435,388,10,6,0,6107,33,13,46,1072,16,43,7,40,16,5477,22,14,36,994,30,59,9,35,9,0.6484149855907781,694,4609,378,1498,0.6357142857142857,560,3435,434,2042,47,AFC South
IND,2011,243,430,2,14,0,4596,14,8,22,938,35,69,15,36,14,5958,25,19,44,1039,29,55,9,46,7,0.5364120781527532,563,2995,375,1601,0.6763005780346821,519,3636,520,2322,-187,AFC South
IND,2012,357,387,11,5,0,5816,23,11,34,1080,41,107,7,58,16,5997,23,14,37,986,32,68,4,35,12,0.5151975683890577,658,4128,422,1688,0.5908289241622575,567,3796,419,2201,-30,AFC South
IND,2013,391,336,11,5,0,5491,23,15,38,1009,32,100,3,27,10,5719,21,14,35,1014,41,77,9,31,15,0.568659127625202,619,3741,390,1750,0.5654450261780105,573,3711,441,2008,55,AFC South
IND,2014,458,369,11,5,0,6514,42,9,51,1086,29,91,14,39,16,5491,27,14,41,995,41,80,13,38,12,0.5942028985507246,690,4894,396,1620,0.5515463917525774,582,3673,413,1818,89,AFC South
IND,2015,333,408,8,8,0,5165,26,6,32,1029,37,108,9,37,18,6082,29,14,43,1057,35,81,7,52,17,0.5444785276073619,652,3706,377,1459,0.5728155339805825,618,4114,439,1968,-75,AFC South
IND,2016,411,392,8,8,0,5853,32,13,45,1015,44,119,7,22,14,6137,27,12,39,1011,33,75,9,28,8,0.592948717948718,624,4206,391,1647,0.6150081566068516,613,4200,398,1937,19,AFC South
IND,2017,263,404,4,12,0,4564,13,11,24,980,55,108,6,52,9,5902,23,15,38,1012,26,73,5,46,13,0.5297397769516728,538,2892,442,1672,0.5914972273567468,541,3952,471,1950,-141,AFC South
IND,2018,433,344,10,6,0,6210,39,13,52,1046,18,75,9,32,15,5439,21,12,33,981,38,74,10,56,14,0.6545454545454545,660,4465,386,1745,0.6689895470383276,574,3805,407,1634,89,AFC South
CIN,2009,305,291,10,6,0,4961,21,9,30,996,29,52,10,50,13,4829,18,12,30,965,34,68,6,30,19,0.5708582834331337,501,2892,495,2069,0.5520833333333334,576,3249,389,1580,14,AFC North
CIN,2010,322,395,4,12,0,5319,26,8,34,1032,28,69,11,42,19,5333,21,15,36,938,27,70,8,28,14,0.5951219512195122,615,3784,417,1535,0.6070763500931099,537,3471,401,1862,-73,AFC North
CIN,2011,344,323,9,7,0,5126,21,10,31,1004,25,54,5,45,14,5071,21,14,35,994,45,96,12,43,10,0.5509838998211091,559,3340,445,1786,0.55,580,3385,414,1686,21,AFC North
CIN,2012,391,320,10,6,0,5340,28,11,39,994,46,58,10,24,16,5129,16,13,29,1021,51,83,13,38,14,0.5756013745704467,582,3578,412,1762,0.569078947368421,608,3393,413,1736,71,AFC North
CIN,2013,430,305,11,5,0,5909,33,14,47,1073,29,43,10,39,18,4894,22,6,28,1030,43,95,10,22,19,0.5947712418300654,612,4139,461,1770,0.556923076923077,650,3344,380,1550,125,AFC North
CIN,2014,365,344,10,5,1,5585,20,19,39,1004,23,45,8,39,16,5756,18,16,34,1055,20,68,5,36,19,0.6152380952380953,525,3423,479,2162,0.5877616747181964,621,3888,434,1868,21,AFC North
CIN,2015,419,279,12,4,0,5748,31,18,49,984,31,51,8,36,6,5470,18,8,26,1019,42,92,6,35,21,0.6278195488721805,532,3924,452,1824,0.611764705882353,680,3989,339,1481,140,AFC North
CIN,2016,325,315,6,9,1,5719,18,17,35,1038,41,64,7,37,8,5627,22,12,34,1022,33,94,4,39,14,0.6056572379367721,601,3942,437,1777,0.6022544283413849,621,3800,401,1827,10,AFC North
CIN,2017,290,349,7,9,0,4506,25,6,31,904,40,56,9,48,12,5431,20,13,33,1081,41,91,3,51,10,0.5577981651376147,545,3122,359,1384,0.5609348914858097,599,3379,482,2052,-59,AFC North
CIN,2018,368,455,6,10,0,4980,27,13,40,929,37,68,3,42,12,6634,32,17,49,1066,34,80,6,32,12,0.5746527777777778,576,3292,353,1688,0.6325203252032521,615,4418,451,2216,-87,AFC North
CAR,2009,315,308,8,8,0,5315,16,18,34,1007,33,57,9,59,20,5063,14,15,29,962,31,64,13,41,22,0.5333333333333333,495,2801,512,2514,0.5842911877394636,522,3056,440,2007,7,NFC South
CAR,2010,196,408,2,14,0,4137,9,7,16,953,50,88,14,47,20,5389,19,20,39,1041,31,68,11,56,17,0.4857685009487666,527,2289,426,1848,0.5895117540687161,553,3393,488,1996,-212,NFC South
CAR,2011,406,429,6,10,0,6245,21,26,47,988,36,62,6,32,16,6056,28,18,46,957,31,44,8,39,14,0.5641952983725136,553,3830,435,2415,0.6115384615384616,520,3949,437,2107,-23,NFC South
CAR,2012,357,363,7,9,0,5768,19,21,40,976,36,59,5,55,12,5344,22,11,33,1000,39,54,10,30,10,0.5419847328244275,524,3683,452,2085,0.6256323777403036,593,3570,407,1774,-6,NFC South
CAR,2013,366,241,12,4,0,5076,24,14,38,979,43,58,3,41,12,4833,17,4,21,958,60,95,9,37,18,0.5703125,512,3041,467,2035,0.6067961165048543,618,3431,340,1402,125,NFC South
CAR,2014,339,374,7,8,1,5546,23,10,33,1053,43,64,9,47,12,5447,25,14,39,977,40,70,12,39,13,0.5580204778156996,586,3513,467,2033,0.6138279932546374,593,3645,384,1802,-35,NFC South
CAR,2015,500,308,15,1,0,5888,35,19,54,1040,33,60,9,44,10,5174,21,11,32,1045,44,99,14,43,22,0.5649717514124294,531,3589,509,2299,0.5710102489019033,683,3754,362,1420,192,NFC South
CAR,2016,369,402,6,10,0,5508,21,16,37,1044,36,92,8,38,17,5780,27,11,38,1025,48,78,10,45,17,0.5134228187919463,596,3689,448,1819,0.6187594553706506,661,4295,364,1485,-33,NFC South
CAR,2017,363,327,11,5,0,5204,22,15,37,1007,35,68,5,44,16,5092,25,7,32,936,50,90,11,46,8,0.5476635514018692,535,3077,472,2127,0.5919055649241147,593,3667,343,1425,36,NFC South
CAR,2018,376,382,7,9,0,5992,28,17,45,994,32,74,4,24,16,5669,32,13,45,935,35,68,9,54,13,0.6395939086294417,591,3840,403,2152,0.6281138790035588,562,3849,373,1820,-6,NFC South
BAL,2009,391,261,9,7,0,5627,21,22,43,1001,37,67,7,45,12,4818,17,8,25,973,32,57,9,51,18,0.5933456561922366,541,3413,460,2214,0.5583941605839416,548,3316,425,1502,130,AFC North
BAL,2010,357,270,12,4,0,5184,25,11,36,999,40,71,8,37,10,5103,22,5,27,996,27,59,6,31,19,0.5811320754716981,530,3335,469,1849,0.5638126009693053,619,3593,377,1510,87,AFC North
BAL,2011,378,266,12,4,0,5442,21,15,36,1013,33,67,10,33,9,4630,11,10,21,990,48,82,11,30,15,0.5479930191972077,573,3423,440,2019,0.49740932642487046,579,3140,411,1490,112,AFC North
BAL,2012,398,344,10,6,0,5657,22,17,39,1025,38,63,4,30,10,5626,15,15,30,1074,37,79,10,42,13,0.561344537815126,595,3741,430,1916,0.5704584040747029,589,3656,485,1970,54,AFC North
BAL,2013,320,352,8,8,0,4931,19,7,26,1082,48,82,6,42,23,5392,25,7,32,1015,41,77,5,33,13,0.545045045045045,666,3594,416,1337,0.5322033898305085,590,3681,425,1711,-32,AFC North
BAL,2014,409,302,10,6,0,5855,27,16,43,999,19,54,6,41,11,5389,22,8,30,1028,51,104,11,34,11,0.607773851590106,566,3819,433,2036,0.5913312693498453,646,3974,382,1415,107,AFC North
BAL,2015,328,401,5,11,0,5767,21,8,29,1076,24,72,5,41,21,5408,30,10,40,990,37,81,6,41,6,0.6143884892086331,695,4286,381,1481,0.5993150684931506,584,3734,406,1674,-73,AFC North
BAL,2016,343,321,8,8,0,5580,20,10,30,1063,32,71,4,39,16,5165,28,10,38,979,31,77,9,41,17,0.6223479490806223,707,4109,356,1471,0.6109271523178808,604,3724,375,1441,22,AFC North
BAL,2017,395,303,9,7,0,4903,20,14,34,1034,27,57,4,56,13,5239,18,12,30,1033,41,86,12,46,21,0.6162988115449916,589,3030,445,1873,0.5504132231404959,605,3421,428,1818,92,AFC North
BAL,2018,389,287,10,6,0,6018,18,19,37,1114,32,63,10,31,9,4697,21,11,32,965,43,96,5,39,10,0.5699658703071673,586,3558,528,2460,0.5453074433656958,618,3362,347,1335,102,AFC North
ATL,2009,363,325,9,7,0,5462,26,15,41,1025,27,50,7,30,16,5590,25,10,35,984,28,55,11,41,15,0.5636672325976231,589,3571,436,1891,0.5989304812834224,561,3873,423,1717,38,NFC South
ATL,2010,414,288,13,3,0,5482,28,14,42,1082,23,52,8,41,9,5327,23,9,32,943,31,49,7,38,19,0.6,600,3571,482,1911,0.6243567753001715,583,3627,360,1700,126,NFC South
ATL,2011,402,350,10,6,0,6063,29,14,43,1044,25,74,7,59,13,5342,25,10,35,959,34,76,8,42,19,0.5964052287581699,612,4200,432,1863,0.5743243243243243,592,3783,367,1559,52,NFC South
ATL,2012,419,299,13,3,0,5895,32,12,44,1009,28,81,4,45,14,5853,14,16,30,986,29,62,11,46,19,0.65527950310559,644,4509,365,1386,0.5820379965457686,579,3878,407,1975,120,NFC South
ATL,2013,353,443,4,12,0,5516,26,11,37,1013,44,97,9,36,17,6081,31,14,45,993,32,51,10,37,10,0.6351931330472103,699,4253,314,1263,0.6222627737226277,548,3897,445,2184,-90,NFC South
ATL,2014,381,417,6,10,0,6060,28,11,39,1024,30,85,8,34,14,6392,20,21,41,1021,23,61,8,30,14,0.6381679389312978,655,4558,369,1502,0.6179001721170396,581,4475,440,1917,-36,NFC South
ATL,2015,339,345,8,8,0,6010,21,13,34,1058,32,80,13,47,16,5573,19,20,39,980,19,69,8,36,13,0.6288343558282209,652,4384,406,1626,0.6390328151986183,579,3882,401,1691,-6,NFC South
ATL,2016,540,406,11,5,0,6670,38,20,58,987,37,95,4,49,7,5966,31,15,46,1051,35,73,8,28,12,0.6481802426343154,577,4727,410,1943,0.6115942028985507,690,4268,361,1698,134,NFC South
ATL,2017,353,315,10,6,0,5849,21,12,33,970,24,81,5,43,11,5110,22,9,31,978,39,81,7,40,8,0.6247723132969034,549,3990,421,1859,0.6146010186757216,589,3431,389,1679,38,NFC South
ATL,2018,414,423,7,9,0,6237,36,11,47,1006,42,105,11,53,7,6172,33,16,49,1021,37,74,3,24,15,0.6465256797583081,662,4657,344,1580,0.6388443017656501,623,4153,398,2019,-9,NFC South
ARI,2009,375,325,10,6,0,5527,28,15,43,959,26,84,16,42,18,5556,22,13,35,1025,43,69,6,48,19,0.6400651465798045,614,4021,345,1506,0.5483359746434231,631,3744,394,1812,50,NFC West
ARI,2010,289,434,5,11,0,4301,10,9,19,926,50,84,11,38,17,6008,22,19,41,1075,33,66,11,44,17,0.4718543046357616,604,2913,322,1388,0.5772646536412078,563,3668,512,2340,-145,NFC West
ARI,2011,312,348,8,8,0,5202,21,12,33,976,54,76,8,31,22,5698,17,15,32,1074,42,75,9,53,10,0.5142378559463987,597,3567,379,1635,0.5528455284552846,615,3696,459,2002,-36,NFC West
ARI,2012,250,357,5,11,0,4215,11,10,21,1009,57,89,10,52,18,5426,20,12,32,1021,38,78,8,35,22,0.5106060606060606,660,3005,349,1210,0.5065666041275797,533,3203,488,2223,-107,NFC West
ARI,2013,379,324,10,6,0,5564,24,12,36,1017,41,92,9,39,22,5072,29,5,34,1024,47,106,8,49,19,0.5912052117263844,614,4002,403,1562,0.55052790346908,663,3707,361,1365,55,NFC West
ARI,2014,310,299,11,5,0,5138,21,6,27,981,28,95,5,43,11,5904,22,9,31,999,35,77,6,48,18,0.5360134003350083,597,3810,384,1328,0.5954323001631321,613,4152,386,1752,11,NFC West
ARI,2015,489,313,13,3,0,6562,35,16,51,1000,27,97,9,47,12,5159,24,9,33,977,36,95,12,54,19,0.610726643598616,578,4616,422,1946,0.5622950819672131,610,3691,367,1468,176,NFC West
ARI,2016,418,362,7,8,1,5877,28,20,48,1077,41,112,11,39,17,4896,21,16,37,1007,48,97,11,60,13,0.5597667638483965,686,4142,391,1735,0.5791245791245792,594,3366,413,1530,56,NFC West
ARI,2017,295,361,8,8,0,5036,21,6,27,1042,51,115,7,42,17,4982,24,12,36,1001,36,93,5,54,13,0.5224111282843895,647,3637,395,1399,0.5726210350584308,599,3543,402,1439,-66,NFC West
ARI,2018,225,425,3,13,0,3875,15,9,24,894,52,106,10,32,18,5760,21,25,46,1056,49,83,9,57,7,0.5173674588665448,547,2525,347,1350,0.6173285198555957,554,3264,502,2496,-200,NFC West
SEA,2009,280,390,5,11,0,5076,20,7,27,1038,41,84,11,45,19,5719,27,17,44,1009,28,86,8,45,12,0.5731895223420647,649,3503,389,1573,0.6328257191201354,591,3929,418,1790,-110,NFC West
SEA,2010,310,407,7,9,0,4784,14,13,27,945,35,57,9,49,19,5919,31,13,44,1055,37,71,7,31,11,0.561525129982669,577,3343,368,1441,0.5485436893203883,618,3998,437,1921,-97,NFC West
SEA,2011,321,315,7,9,0,4871,15,15,30,994,48,106,9,45,14,5309,18,10,28,1023,34,67,7,44,19,0.5377697841726619,556,3108,438,1763,0.5714285714285714,567,3516,456,1793,6,NFC West
SEA,2012,412,245,11,5,0,5627,27,16,43,959,33,61,7,43,10,4899,15,8,23,954,37,77,8,27,14,0.5926773455377574,437,3031,522,2596,0.5505050505050505,594,3243,360,1656,167,NFC West
SEA,2013,417,231,13,3,0,5446,27,14,41,951,44,89,8,52,8,4387,16,4,20,978,44,93,8,39,28,0.5804347826086956,460,3236,491,2210,0.5430579964850615,569,2756,409,1631,186,NFC West
SEA,2014,394,254,12,4,0,6032,20,20,40,1000,42,86,5,41,7,4271,17,8,25,918,37,82,8,49,13,0.5809716599190283,494,3250,506,2782,0.5772058823529411,544,2969,374,1302,140,NFC West
SEA,2015,423,277,10,6,0,6085,34,10,44,1013,46,109,7,42,8,4684,14,10,24,935,37,96,9,41,12,0.624765478424015,533,3790,480,2295,0.5711835334476844,583,3368,352,1316,146,NFC West
SEA,2016,354,292,10,5,1,5737,23,13,36,995,42,105,7,46,12,5125,16,16,32,1011,41,98,8,49,10,0.6052631578947368,608,4126,387,1611,0.5726643598615917,578,3622,433,1503,62,NFC West
SEA,2017,366,332,9,7,0,5284,34,4,38,984,43,114,5,51,10,5183,19,14,33,1023,39,101,8,49,11,0.5755517826825127,589,3655,395,1629,0.5565068493150684,584,3348,439,1835,34,NFC West
SEA,2018,428,347,10,6,0,5667,35,15,50,985,51,90,4,36,7,5663,26,9,35,947,43,105,12,33,11,0.5995717344753747,467,3095,518,2572,0.60580204778157,586,3842,361,1821,81,NFC West
NYG,2009,402,427,8,8,0,5867,28,14,42,1004,32,63,14,43,14,5195,31,21,52,940,33,77,8,52,13,0.5919439579684763,571,4019,433,1848,0.5924528301886792,530,3418,410,1777,-25,NFC East
NYG,2010,394,347,10,6,0,6107,31,17,48,1011,16,47,18,46,24,4986,24,11,35,965,47,93,21,37,16,0.6163636363636363,550,3885,461,2222,0.5255972696245734,586,3353,379,1633,47,NFC East
NYG,2011,394,400,9,7,0,6165,29,17,46,1006,28,64,7,39,16,6016,28,15,43,1055,48,84,9,43,18,0.5849673202614379,612,4711,394,1454,0.5703001579778831,633,4084,422,1932,-6,NFC East
NYG,2012,429,344,9,7,0,5309,25,16,41,894,19,45,6,30,12,5679,24,9,33,924,30,57,6,32,19,0.5766990291262136,515,3496,379,1813,0.6033834586466166,532,3836,392,1843,85,NFC East
NYG,2013,294,383,7,9,0,4932,18,11,29,974,40,77,12,48,28,5349,21,12,33,1069,34,78,9,40,16,0.540765391014975,601,3588,373,1344,0.5739268680445151,629,3592,440,1757,-89,NFC East
NYG,2014,380,400,6,10,0,5884,30,13,43,1074,30,64,10,38,13,6032,25,15,40,988,47,88,9,31,15,0.6041009463722398,634,4272,440,1612,0.5724381625441696,566,3852,422,2180,-20,NFC East
NYG,2015,420,442,6,10,0,5967,36,5,41,1042,27,65,7,38,14,6747,31,15,46,1088,23,76,13,37,13,0.6068111455108359,646,4347,396,1620,0.6443768996960486,658,4793,430,1954,-22,NFC East
NYG,2016,310,284,11,5,0,5309,26,6,32,997,22,57,9,34,15,5444,15,10,25,1047,35,81,7,38,15,0.6110210696920584,617,3877,380,1432,0.5599393019726859,659,4018,388,1426,26,NFC East
NYG,2017,246,388,3,13,0,5040,20,6,26,1029,35,65,8,37,13,5992,32,10,42,1028,27,60,6,41,12,0.5819032761310452,641,3479,388,1561,0.5951972555746141,583,4038,445,1954,-142,NFC East
NYG,2018,369,412,5,11,0,5711,23,13,36,985,47,96,5,42,12,5966,24,18,42,1013,30,81,5,46,15,0.6025236593059937,634,4053,351,1658,0.6188034188034188,585,4048,428,1918,-43,NFC East
GB,2009,461,297,11,5,0,6091,30,20,50,1021,50,87,7,33,7,4556,29,5,34,944,37,86,9,51,29,0.5940099833610649,601,4198,420,1893,0.5104166666666666,576,3220,368,1336,164,NFC North
GB,2010,388,240,10,6,0,5744,31,11,42,981,38,65,7,35,12,4947,16,6,22,964,46,84,6,30,23,0.6132404181184669,574,4124,407,1620,0.5202108963093146,569,3107,395,1840,148,NFC North
GB,2011,560,359,15,1,0,6503,51,12,63,963,41,65,3,35,8,6590,29,10,39,1045,29,62,6,31,31,0.6366723259762309,589,4918,374,1585,0.5849624060150376,665,4791,380,1799,201,NFC North
GB,2012,433,336,11,5,0,5771,40,9,49,1026,51,81,7,27,8,5395,24,12,36,1027,47,82,4,32,17,0.6147540983606558,610,4057,416,1714,0.5106035889070146,613,3492,414,1903,97,NFC North
GB,2013,417,428,8,7,1,6419,25,17,42,1061,45,69,7,33,16,5965,30,16,46,1005,44,60,11,38,9,0.5941558441558441,616,4268,445,2151,0.570446735395189,582,3956,423,2009,-11,NFC North
GB,2014,486,348,12,4,0,6202,38,14,52,981,30,56,6,38,6,5504,26,11,37,1039,41,85,8,35,15,0.6176991150442478,565,4261,416,1941,0.555,600,3610,439,1894,138,NFC North
GB,2015,368,323,10,6,0,5374,31,8,39,1044,47,99,9,44,8,5552,20,13,33,1008,43,89,5,53,14,0.5603864734299517,621,3509,423,1865,0.5431472081218274,591,3644,417,1908,45,NFC North
GB,2016,432,388,10,6,0,5923,40,11,51,1012,35,72,8,37,7,5833,32,11,43,982,41,78,7,45,17,0.6162079510703364,654,4201,358,1722,0.6035889070146819,613,4298,369,1535,44,NFC North
GB,2017,320,384,7,9,0,4897,25,13,38,982,51,97,5,22,13,5602,30,10,40,1000,37,73,9,53,10,0.5818181818181818,605,3169,377,1728,0.6338797814207651,549,3793,451,1809,-64,NFC North
GB,2018,376,400,6,9,1,5917,25,14,39,1017,53,98,6,31,4,5690,30,15,45,1001,44,72,7,29,7,0.5689404934687954,689,4242,328,1675,0.5884413309982487,571,3756,430,1934,-24,NFC North
NE,2009,427,285,10,6,0,6380,28,19,47,1062,18,67,9,35,13,5132,25,6,31,926,31,64,7,26,16,0.6372549019607843,612,4438,450,1942,0.5597014925373134,536,3355,390,1777,142,AFC East
NE,2010,518,313,14,2,0,5879,37,19,56,964,25,48,4,22,5,5875,25,10,35,1054,35,62,12,30,23,0.623352165725047,531,3847,433,2032,0.6040372670807453,644,4137,410,1738,205,AFC East
NE,2011,513,342,13,3,0,6869,39,18,57,1066,32,66,3,28,10,6591,26,13,39,1056,40,82,8,34,22,0.6291079812206573,639,5088,427,1781,0.5887708649468892,659,4722,397,1869,171,AFC East
NE,2012,557,331,12,4,0,6827,34,25,59,1175,27,65,6,50,8,5945,27,10,37,1033,36,64,20,45,19,0.6075757575757575,660,4634,515,2193,0.5906902086677368,623,4306,410,1639,226,AFC East
NE,2013,444,338,12,4,0,6157,25,19,44,1112,39,75,9,33,11,5974,25,11,36,1107,48,87,9,33,16,0.5742424242424242,660,4086,452,2071,0.5316455696202531,632,3824,475,2150,106,AFC East
NE,2014,468,313,12,4,0,5880,34,13,47,1054,26,75,4,40,8,5526,24,6,30,1022,40,72,8,32,14,0.6208530805687204,633,4121,421,1759,0.5570032573289903,614,3843,408,1683,155,AFC East
NE,2015,465,315,12,4,0,6012,36,14,50,1029,38,94,4,30,7,5439,24,8,32,1038,49,86,8,41,12,0.6075187969924812,665,4587,364,1425,0.5579598145285936,647,3854,391,1585,150,AFC East
NE,2016,441,250,14,2,0,6202,32,19,51,1033,24,62,6,41,2,5230,21,6,27,991,34,65,7,26,12,0.6456140350877193,570,4310,463,1892,0.5878594249201278,626,3810,365,1420,191,AFC East
NE,2017,458,296,13,3,0,6297,32,16,48,1052,35,83,4,38,7,5869,24,6,30,1007,42,85,5,28,12,0.6258064516129033,620,4396,432,1901,0.5862619808306709,626,4022,381,1847,162,AFC East
NE,2018,436,325,11,5,0,6313,29,18,47,1050,21,66,5,23,10,5752,29,7,36,993,30,93,10,29,18,0.6385135135135135,592,4258,458,2055,0.5863708399366085,631,3943,362,1809,111,AFC East
OAK,2009,197,379,5,11,0,4266,10,7,17,927,48,80,14,31,17,5806,16,24,40,1004,37,59,7,54,6,0.4866412213740458,524,2557,403,1709,0.5498938428874734,471,3303,533,2503,-182,AFC West
OAK,2010,410,371,8,8,0,5686,18,19,37,1020,45,58,9,33,16,5163,29,14,43,970,47,76,7,54,12,0.527306967984934,531,3177,489,2509,0.48627450980392156,510,3012,460,2151,39,AFC West
OAK,2011,359,433,8,8,0,6077,20,16,36,1005,25,58,7,38,20,6213,31,15,46,1044,39,74,6,37,16,0.5798165137614679,545,3960,460,2117,0.5167464114832536,627,4029,417,2184,-74,AFC West
OAK,2012,290,443,4,12,0,5511,24,4,28,1026,27,58,8,47,15,5683,28,18,46,972,25,78,6,49,11,0.5758039816232772,653,4088,373,1423,0.6343692870201096,547,3775,425,1908,-153,AFC West
OAK,2013,322,453,4,12,0,5342,17,16,33,983,45,60,8,30,18,5834,33,15,48,1016,39,69,9,45,9,0.5341726618705036,556,3340,427,2002,0.6416382252559727,586,4112,430,1722,-131,AFC West
OAK,2014,253,452,3,13,0,4520,22,4,26,978,27,51,11,31,14,5743,29,17,46,1023,22,54,4,54,9,0.5658914728682171,645,3280,333,1240,0.6125,560,3810,463,1933,-199,AFC West
OAK,2015,359,399,7,9,0,5343,34,7,41,995,33,54,6,31,13,5834,25,12,37,1076,38,60,8,41,12,0.5855572998430141,637,3876,358,1467,0.5958702064896755,678,4148,398,1686,-40,AFC West
OAK,2016,416,385,12,4,0,6007,29,17,46,1029,19,36,7,31,7,6020,27,18,45,978,25,67,11,34,16,0.6156351791530945,614,4055,415,1952,0.5805309734513274,565,4124,413,1896,31,AFC West
OAK,2017,301,373,6,10,0,5199,23,13,36,941,24,45,13,42,12,5624,24,11,35,979,31,66,7,38,5,0.5972461273666093,581,3635,360,1564,0.6464285714285715,560,3857,419,1767,-72,AFC West
OAK,2018,290,467,4,12,0,5393,19,9,28,976,52,86,14,33,9,6129,36,16,52,954,13,48,3,38,14,0.6366666666666667,600,3753,376,1640,0.6052631578947368,494,3855,460,2274,-177,AFC West
DET,2009,262,494,2,14,0,4790,16,9,25,1021,42,84,7,55,29,6300,36,17,53,1001,26,53,11,49,9,0.5138211382113821,615,3170,406,1620,0.657243816254417,566,4254,435,2046,-232,NFC North
DET,2010,362,369,6,10,0,5461,27,11,38,1059,27,56,8,47,16,5511,23,18,41,989,45,77,12,43,13,0.5842185128983308,659,3847,400,1614,0.5871886120996441,562,3497,427,2014,-7,NFC North
DET,2011,474,387,10,6,0,6645,41,12,53,1089,38,78,6,28,13,6199,29,10,39,1069,45,71,12,31,20,0.6091160220994475,724,5086,365,1559,0.5975794251134644,661,4121,408,2078,87,NFC North
DET,2012,372,437,4,12,0,6546,22,17,39,1149,29,76,13,32,15,5556,26,14,40,981,32,91,5,66,10,0.583989501312336,762,4927,387,1619,0.6070175438596491,570,3578,411,1978,-65,NFC North
DET,2013,395,376,7,9,0,6290,29,15,44,1086,24,64,15,38,17,5584,24,10,34,970,33,79,7,47,14,0.5672782874617737,654,4478,432,1812,0.555921052631579,608,3956,362,1628,19,NFC North
DET,2014,321,282,11,5,0,5462,22,11,33,1021,45,83,5,38,10,4820,23,8,31,974,43,104,7,51,19,0.567651632970451,643,4022,378,1440,0.6079365079365079,630,3702,344,1118,39,NFC North
DET,2015,358,400,7,9,0,5564,33,7,40,1018,44,98,8,38,14,5611,27,18,45,984,42,91,8,54,9,0.6231454005934718,674,4212,344,1352,0.6333333333333333,570,3792,414,1819,-42,NFC North
DET,2016,346,358,9,7,0,5430,24,9,33,970,37,74,4,48,10,5700,33,8,41,950,26,63,4,31,10,0.6178343949044586,628,4111,342,1319,0.6939130434782609,575,3979,375,1721,-12,NFC North
DET,2017,410,376,9,7,0,5417,29,10,39,973,47,83,11,52,10,5712,21,18,39,1024,35,87,12,40,18,0.6051779935275081,618,4187,355,1230,0.6039603960396039,606,3895,418,1817,34,NFC North
DET,2018,324,360,6,10,0,5246,22,11,33,1013,41,81,7,40,12,5379,29,11,40,929,43,74,5,27,6,0.6077795786061588,617,3576,396,1670,0.5992578849721707,539,3603,390,1776,-36,NFC North
WAS,2009,266,336,4,12,0,5019,21,8,29,956,45,86,7,30,15,5140,19,10,29,979,40,74,7,42,11,0.5961538461538461,572,3499,384,1520,0.5737704918032787,549,3320,430,1820,-70,NFC East
WAS,2010,302,377,6,10,0,5386,21,9,30,992,46,96,11,53,19,6243,23,15,38,1040,29,63,11,27,12,0.5377503852080123,649,3917,343,1469,0.6056105610561056,606,4189,434,2054,-75,NFC East
WAS,2011,288,367,5,11,0,5376,19,8,27,1011,39,95,11,34,20,5447,22,15,37,972,41,69,7,25,13,0.5580645161290323,620,3772,391,1604,0.5620437956204379,548,3553,424,1894,-79,NFC East
WAS,2012,436,388,10,6,0,5666,22,22,44,910,32,70,3,40,7,5667,30,9,39,967,31,61,10,30,19,0.6167800453514739,441,3188,469,2478,0.5853269537480064,627,4186,340,1481,48,NFC East
WAS,2013,334,478,3,13,0,5922,20,14,34,1102,41,85,14,46,18,5689,29,23,52,967,36,67,9,50,15,0.5476923076923077,650,3767,452,2155,0.614963503649635,548,3896,419,1793,-144,NFC East
WAS,2014,301,438,4,12,0,5744,18,15,33,995,58,99,12,41,17,5698,35,11,46,969,38,71,9,30,7,0.6076794657762938,599,4047,396,1697,0.6211849192100538,557,3971,412,1727,-137,NFC East
WAS,2015,388,379,9,7,0,5681,30,9,39,1000,27,72,9,53,11,6096,30,10,40,1006,38,72,16,39,11,0.6598290598290598,585,4099,415,1582,0.5860927152317881,604,4127,402,1969,9,NFC East
WAS,2016,396,383,8,7,1,6471,25,17,42,996,23,78,9,33,11,6053,22,19,41,1039,38,87,7,40,12,0.6480891719745223,628,4758,368,1713,0.6211878009630819,623,4128,416,1925,13,NFC East
WAS,2017,342,388,7,9,0,5209,27,10,37,970,41,94,10,47,12,5543,23,13,36,1033,43,94,7,33,15,0.6003460207612457,578,3751,392,1458,0.5359019264448336,571,3421,462,2122,-46,NFC East
WAS,2018,281,359,7,9,0,4807,16,12,28,956,44,93,4,56,15,5677,27,12,39,980,46,91,10,23,15,0.5664845173041895,549,3025,407,1782,0.6198630136986302,584,3798,396,1879,-78,NFC East
TEN,2009,354,402,8,8,0,5636,16,19,35,978,14,41,13,50,15,5875,31,16,47,1016,32,81,6,39,18,0.555327868852459,488,3031,490,2605,0.6396825396825396,630,4131,386,1744,-48,AFC South
TEN,2010,356,339,6,10,0,4846,24,13,37,893,27,40,12,52,14,5890,23,7,30,1126,40,87,7,53,16,0.5481927710843374,498,3109,395,1737,0.6231003039513677,658,4016,468,1874,17,AFC South
TEN,2011,325,317,9,7,0,5374,22,8,30,968,24,49,8,43,14,5687,21,10,31,1066,28,56,12,45,11,0.5844370860927153,604,3923,364,1451,0.601957585644372,613,3629,453,2058,8,AFC South
TEN,2012,330,471,6,10,0,5014,17,10,27,944,39,59,12,50,13,6013,31,16,47,1064,39,78,5,42,16,0.5549738219895288,573,3319,371,1695,0.6233333333333333,600,3959,464,2054,-141,AFC South
TEN,2013,362,381,7,9,0,5402,22,16,38,1017,37,74,5,43,16,5422,15,21,36,1009,36,68,12,37,13,0.5805309734513274,565,3496,452,1906,0.5951557093425606,578,3612,431,1810,-19,AFC South
TEN,2014,254,438,2,14,0,4832,19,6,25,901,50,87,8,21,15,5936,28,17,45,1072,39,60,4,47,12,0.5359712230215827,556,3372,345,1460,0.5982758620689655,580,3774,492,2162,-184,AFC South
TEN,2015,299,423,3,13,0,4999,25,10,35,968,54,90,14,46,16,5496,34,11,45,981,39,58,4,30,11,0.5690515806988353,601,3507,367,1492,0.589648798521257,541,3675,440,1821,-124,AFC South
TEN,2016,381,378,9,7,0,5742,29,16,45,995,29,48,7,43,11,5736,25,10,35,1017,40,86,4,32,11,0.5770676691729323,532,3533,463,2209,0.5773809523809523,672,4307,345,1429,3,AFC South
TEN,2017,334,356,9,7,0,5037,14,18,32,958,35,67,7,49,16,5266,27,5,32,1030,42,79,8,38,11,0.5795454545454546,528,3191,430,1846,0.5772230889235569,641,3836,389,1430,-22,AFC South
TEN,2018,310,303,9,7,0,5007,16,15,31,928,47,64,5,51,11,5346,21,9,30,985,39,80,6,28,10,0.6066252587991718,483,2975,445,2032,0.5933098591549296,568,3471,417,1875,7,AFC South
PHI,2009,429,337,11,5,0,5750,27,14,41,955,40,52,7,26,12,5151,27,11,38,1023,44,70,9,41,23,0.5668358714043993,591,4086,364,1664,0.5709677419354838,620,3464,403,1687,92,NFC East
PHI,2010,439,377,10,6,0,6245,28,18,46,1020,50,83,10,24,12,5239,31,12,43,981,38,58,11,54,19,0.5742574257425742,606,3904,414,2341,0.544973544973545,567,3473,414,1766,62,NFC East
PHI,2011,396,328,8,8,0,6399,22,20,42,1016,33,65,9,55,25,5216,27,11,38,967,50,86,9,49,13,0.5699481865284974,579,4110,437,2289,0.5335689045936396,566,3397,401,1819,68,NFC East
PHI,2012,280,444,4,12,0,5675,18,10,28,1065,48,106,18,51,14,5506,32,12,44,974,30,49,4,55,6,0.5577507598784195,658,3781,407,1894,0.5705882352941176,510,3457,464,2049,-164,NFC East
PHI,2013,442,382,10,6,0,6693,32,19,51,1035,45,73,10,52,8,6324,25,12,37,1135,37,50,11,33,19,0.5605786618444847,553,4126,482,2567,0.5811965811965812,702,4639,433,1685,60,NFC East
PHI,2014,474,400,10,6,0,6307,27,16,43,1109,32,58,14,52,20,5984,29,14,43,1093,49,66,16,52,12,0.5929339477726574,651,4356,458,1951,0.5408805031446541,636,4198,457,1786,74,NFC East
PHI,2015,377,430,7,9,0,5839,23,15,38,1090,37,92,13,48,18,6448,36,10,46,1125,37,78,9,46,15,0.6155015197568389,658,4087,432,1752,0.5907046476761619,667,4275,458,2173,-53,NFC East
PHI,2016,367,331,7,9,0,5420,16,16,32,1070,33,91,6,53,13,5504,25,10,35,960,34,83,9,55,16,0.59375,640,3587,430,1833,0.568259385665529,586,3832,374,1672,36,NFC East
PHI,2017,457,295,13,3,0,5874,38,9,47,1053,36,104,9,57,9,4893,24,7,31,967,38,104,11,59,18,0.5711892797319933,597,3737,456,2137,0.5707547169811321,636,3637,331,1256,162,NFC East
PHI,2018,367,348,9,7,0,5866,29,12,41,1027,40,98,11,39,11,5867,22,14,36,996,44,125,6,44,10,0.6635220125786163,636,4277,391,1589,0.6223880597014926,670,4310,326,1557,19,NFC East
NYJ,2009,348,236,9,7,0,5158,12,21,33,1012,30,42,9,43,19,4050,8,11,19,944,32,67,10,48,17,0.5011933174224343,419,2382,593,2776,0.48592870544090055,533,2459,411,1591,112,AFC East
NYJ,2010,367,304,11,5,0,5629,20,14,34,1073,28,46,7,30,13,4712,24,11,35,968,40,71,16,32,11,0.526508226691042,547,3244,526,2385,0.4735915492957746,568,3209,400,1503,63,AFC East
NYJ,2011,377,363,8,8,0,4996,26,14,40,1018,40,65,10,33,17,5007,15,17,32,973,35,60,10,46,18,0.5326460481099656,582,3297,436,1699,0.5159474671669794,533,3216,440,1791,14,AFC East
NYJ,2012,281,375,6,10,0,4753,14,12,26,1024,46,67,15,33,18,5165,20,17,37,995,30,59,11,40,10,0.5065420560747663,535,2857,489,1896,0.5125725338491296,517,3008,478,2157,-94,AFC East
NYJ,2013,290,387,8,8,0,5096,13,12,25,1007,47,91,7,37,18,5381,26,9,35,1033,41,76,1,50,11,0.5095785440613027,522,2932,485,2164,0.5521669341894061,623,3957,410,1424,-97,AFC East
NYJ,2014,283,401,4,12,0,5194,16,11,27,1042,47,84,7,48,13,5269,31,10,41,955,45,94,4,37,6,0.5304990757855823,541,2946,501,2248,0.5986159169550173,578,3763,377,1506,-118,AFC East
NYJ,2015,387,314,10,6,0,5936,33,11,44,1061,22,68,8,51,16,5110,25,4,29,1000,39,96,10,46,17,0.5782747603833865,626,4057,435,1879,0.5384615384615384,637,3763,363,1347,73,AFC East
NYJ,2016,275,409,5,11,0,5267,16,10,26,994,35,88,8,39,22,5546,30,11,41,976,26,71,5,56,8,0.5370051635111877,581,3467,413,1800,0.6087719298245614,570,3902,406,1644,-134,AFC East
NYJ,2017,298,382,5,11,0,4901,19,13,32,965,47,91,10,52,11,5648,30,13,43,1043,28,88,9,46,10,0.5869565217391305,552,3182,413,1719,0.5643224699828473,583,3753,460,1895,-84,AFC East
NYJ,2018,333,441,4,12,0,4800,18,11,29,954,37,73,9,47,17,6108,29,16,45,1043,39,109,7,40,13,0.5387387387387388,555,3165,399,1635,0.5919354838709677,620,4067,423,2041,-108,AFC East
KC,2009,294,424,4,12,0,4837,18,8,26,1012,45,75,8,52,16,6225,25,18,43,1044,23,40,12,27,14,0.5147313691507799,577,2917,435,1920,0.5738636363636364,528,3705,516,2520,-130,AFC West
KC,2010,366,326,10,6,0,5604,27,13,40,1048,32,70,5,41,8,5293,23,11,34,1009,39,75,7,26,13,0.548,500,2968,548,2636,0.5212418300653595,612,3519,397,1774,40,AFC West
KC,2011,212,338,7,9,0,4984,13,5,18,1001,34,69,6,53,17,5337,23,14,37,977,29,60,7,39,17,0.5714285714285714,525,3086,476,1898,0.5355648535564853,478,3217,499,2120,-126,AFC West
KC,2012,211,425,2,14,0,5117,8,9,17,1002,39,81,15,54,19,5724,29,11,40,953,27,50,3,41,6,0.5404339250493096,507,2713,495,2404,0.5728952772073922,487,3533,466,2191,-214,AFC West
KC,2013,430,305,11,5,0,5413,24,17,41,1004,40,71,9,28,9,5893,25,9,34,1055,47,70,11,29,20,0.5731497418244407,581,3340,423,2073,0.526813880126183,634,3962,421,1931,125,AFC West
KC,2014,353,281,9,7,0,5111,19,17,36,955,49,75,10,36,6,5304,22,4,26,1008,46,77,6,34,5,0.5893186003683242,543,3202,412,1909,0.5408163265306123,588,3254,420,2050,72,AFC West
KC,2015,405,287,11,5,0,5315,20,19,39,941,45,70,6,39,6,5282,25,7,32,1032,47,73,6,32,22,0.5984555984555985,518,3260,423,2055,0.5344563552833078,653,3700,379,1582,118,AFC West
KC,2016,389,311,12,4,0,5511,19,15,34,969,32,65,8,43,8,5909,23,10,33,1054,28,71,11,38,17,0.6325823223570191,577,3742,392,1769,0.5591054313099042,626,3960,428,1949,78,AFC West
KC,2017,415,339,10,6,0,5987,26,12,38,975,37,79,3,36,6,5860,23,15,38,1035,31,66,8,49,16,0.6280276816608996,578,4104,397,1883,0.5416666666666666,600,3954,435,1906,76,AFC West
KC,2018,565,421,12,4,0,6824,50,16,66,982,26,101,6,34,11,6506,30,19,49,1110,52,101,11,29,14,0.6353135313531353,606,4955,376,1869,0.5884057971014492,690,4382,420,2124,144,AFC West
JAX,2009,290,380,7,9,0,5407,15,19,34,991,44,118,12,34,10,5656,28,12,40,969,14,45,9,36,15,0.5645161290322581,558,3361,433,2046,0.6546489563567363,527,3776,442,1880,-90,AFC South
JAX,2010,353,419,8,8,0,5461,26,14,40,1007,37,103,9,31,20,5947,28,19,47,938,26,66,4,43,13,0.5785288270377733,503,3067,504,2394,0.6212121212121212,528,3993,410,1954,-66,AFC South
JAX,2011,243,329,5,11,0,4164,12,9,21,985,44,70,7,44,14,5031,21,14,35,957,31,59,9,35,16,0.47058823529411764,510,2179,475,1985,0.6048237476808905,539,3343,418,1688,-86,AFC South
JAX,2012,255,444,2,14,0,4806,20,5,25,988,51,100,8,26,15,6095,21,19,40,1080,20,58,10,42,12,0.5165876777251185,633,3430,355,1376,0.6166365280289331,553,3834,527,2261,-189,AFC South
JAX,2013,247,449,4,12,0,4390,16,7,23,1011,51,95,6,48,20,5651,29,20,49,1067,31,69,10,39,11,0.5478806907378336,637,3239,374,1151,0.6120689655172413,580,3623,487,2028,-202,AFC South
JAX,2014,249,412,3,13,0,4638,15,9,24,986,71,112,7,32,16,5949,24,15,39,1063,46,66,13,46,6,0.517515923566879,628,3002,358,1636,0.6089193825042881,583,3895,480,2054,-163,AFC South
JAX,2015,376,448,5,11,0,5576,35,5,40,1007,51,80,9,30,17,6025,29,15,44,1079,36,64,8,55,9,0.5386949924127465,659,4110,348,1466,0.6141732283464567,635,4291,444,1734,-72,AFC South
JAX,2016,318,400,3,13,0,5370,24,8,32,1045,34,72,10,43,15,5166,20,18,38,1010,33,70,4,52,7,0.560790273556231,658,3730,387,1640,0.5989583333333334,576,3444,434,1722,-82,AFC South
JAX,2017,417,268,10,6,0,5906,21,18,39,1066,24,72,7,43,13,4591,17,9,26,974,55,89,11,44,18,0.5703971119133574,554,3599,512,2307,0.5197841726618705,556,2720,418,1871,149,AFC South
JAX,2018,245,316,5,11,0,4838,15,7,22,997,53,106,15,35,11,5002,17,16,33,952,37,90,4,43,10,0.5604770017035775,587,3109,410,1729,0.5853658536585366,533,3113,419,1889,-71,AFC South
SF,2009,330,281,8,8,0,4664,23,12,35,922,40,80,6,41,12,5234,14,12,26,1028,44,87,15,40,18,0.5541740674955595,563,3052,359,1612,0.5732899022801303,614,3670,414,1564,49,NFC West
SF,2010,305,346,6,10,0,5022,19,10,29,928,44,84,6,30,14,5250,25,9,34,1021,36,66,8,36,14,0.5280898876404494,534,3358,394,1664,0.6172413793103448,580,3697,441,1553,-41,NFC West
SF,2011,380,229,13,3,0,4970,18,14,32,972,44,78,5,58,5,4942,20,3,23,965,40,84,13,27,22,0.5604838709677419,496,2938,476,2032,0.539708265802269,617,3697,348,1245,151,NFC West
SF,2012,397,273,11,4,1,5801,23,17,40,952,41,65,6,36,8,4727,19,7,26,989,38,65,9,32,13,0.608421052631579,475,3293,477,2508,0.5654362416107382,596,3203,393,1524,124,NFC West
SF,2013,406,272,12,4,0,5195,21,18,39,944,39,54,10,61,8,5084,19,11,30,1007,37,77,7,28,18,0.5362637362637362,455,2979,489,2216,0.5605815831987075,619,3553,388,1531,134,NFC West
SF,2014,306,340,8,8,0,5254,20,10,30,994,52,67,11,49,9,5158,30,6,36,972,36,75,6,35,21,0.5427509293680297,538,3063,456,2191,0.5574614065180102,583,3548,389,1610,-34,NFC West
SF,2015,238,387,5,11,0,4872,16,7,23,958,53,88,3,45,11,6231,21,20,41,1057,28,73,3,38,9,0.5561312607944733,579,3318,379,1554,0.6476683937823834,579,4185,478,2046,-149,NFC West
SF,2016,309,480,2,14,0,4942,21,15,36,988,47,75,11,52,9,6527,30,25,55,1082,33,73,8,46,10,0.5354477611940298,536,2911,452,2031,0.5862068965517241,551,3848,531,2679,-171,NFC West
SF,2017,331,383,6,10,0,5599,15,15,30,1041,43,107,7,46,14,5641,27,13,40,1046,30,94,8,53,10,0.5629860031104199,643,3925,398,1674,0.5986038394415357,573,3756,473,1885,-52,NFC West
SF,2018,342,435,4,12,0,5788,26,7,33,993,48,122,10,50,20,5570,35,13,48,998,37,85,5,39,2,0.5706896551724138,580,3871,413,1917,0.5993031358885017,574,3736,424,1834,-93,NFC West
BUF,2009,258,326,6,10,0,4390,17,6,23,902,46,99,7,37,17,5469,14,19,33,1070,34,69,4,51,27,0.5278350515463918,485,2515,417,1875,0.5344202898550725,552,2939,518,2530,-68,AFC East
BUF,2010,283,425,4,12,0,4872,24,6,30,950,33,84,14,43,20,5800,28,18,46,1055,27,53,9,32,11,0.5391621129326047,549,3150,401,1722,0.592741935483871,496,3074,559,2726,-142,AFC East
BUF,2011,372,434,6,10,0,5629,24,12,36,981,22,65,5,33,23,5958,30,19,49,986,28,49,8,34,18,0.5983193277310924,595,3711,386,1918,0.6045197740112994,531,3722,455,2236,-62,AFC East
BUF,2012,344,435,6,10,0,5498,24,12,36,971,29,66,17,36,17,5820,25,23,48,1028,37,63,8,46,11,0.5743494423791822,538,3269,433,2229,0.5379188712522046,567,3475,461,2345,-91,AFC East
BUF,2013,339,388,6,10,0,5445,16,15,31,1096,48,99,11,52,15,5350,28,10,38,1071,56,90,7,39,21,0.5264084507042254,568,3107,528,2338,0.504885993485342,614,3273,457,2077,-49,AFC East
BUF,2014,343,289,9,7,0,5116,23,7,30,1003,39,79,9,39,12,5007,16,10,26,1012,52,85,9,48,13,0.5941080196399345,611,3616,392,1500,0.5579470198675497,604,3283,408,1724,54,AFC East
BUF,2015,379,359,8,8,0,5799,23,19,42,1002,42,67,7,58,9,5731,30,10,40,1000,21,68,4,25,15,0.5818540433925049,507,3343,495,2456,0.5568,625,3978,375,1753,20,AFC East
BUF,2016,399,378,7,9,0,5679,17,29,46,1007,46,82,5,57,6,5728,19,21,40,1006,39,72,5,38,12,0.5529865125240848,519,3039,488,2640,0.5571687840290381,551,3586,455,2142,21,AFC East
BUF,2017,302,359,9,7,0,4860,16,12,28,992,47,86,6,67,9,5704,14,22,36,1040,27,67,6,55,16,0.5557692307692308,520,2825,472,2035,0.6208053691275168,596,3688,444,2016,-57,AFC East
BUF,2018,269,374,6,10,0,4789,13,15,28,998,41,96,7,45,22,4725,22,17,39,954,36,83,10,61,15,0.5027829313543599,539,2796,459,1993,0.590566037735849,530,2867,424,1858,-105,AFC East
SD,2009,454,320,13,3,0,5773,29,17,46,957,26,45,6,39,9,5235,23,10,33,986,34,47,10,31,13,0.6236162361623616,542,4338,415,1435,0.5780141843971631,564,3348,422,1887,134,AFC West
SD,2010,441,322,9,7,0,6343,30,18,48,1029,38,64,14,34,11,4340,18,14,32,927,48,56,8,41,16,0.6211072664359861,578,4521,451,1822,0.5357142857142857,532,2830,395,1510,119,AFC West
SD,2011,406,377,8,8,0,6300,27,16,43,1034,31,49,8,26,17,5555,29,8,37,947,32,46,4,33,13,0.6029654036243822,607,4426,427,1874,0.5944333996023857,503,3591,444,1964,29,AFC West
SD,2012,350,350,7,9,0,4766,26,4,30,974,49,56,10,34,13,5188,28,10,38,1005,38,64,11,39,13,0.5919439579684763,571,3296,403,1470,0.5745033112582781,604,3683,401,1505,0,AFC West
SD,2013,396,348,9,7,0,6295,32,9,41,1052,30,56,8,23,9,5866,23,14,37,951,34,53,6,27,11,0.6625874125874126,572,4328,480,1967,0.629757785467128,578,4148,373,1718,48,AFC West
SD,2014,348,348,9,7,0,5471,31,6,37,1001,36,70,4,44,16,5413,24,11,35,982,26,45,10,43,6,0.628099173553719,605,4099,396,1372,0.5882352941176471,544,3426,438,1987,0,AFC West
SD,2015,320,398,4,12,0,5960,30,4,34,1094,40,90,10,40,12,5808,22,17,39,947,32,65,7,40,11,0.6274787535410765,706,4596,388,1364,0.6062846580406654,541,3790,406,2018,-78,AFC West
SD,2016,410,423,5,11,0,5718,33,10,43,1006,36,88,12,49,21,5578,21,20,41,1010,35,82,9,59,16,0.5693311582381729,613,4202,393,1516,0.5938009787928222,613,3990,397,1588,-13,AFC West
DEN,2009,326,324,8,8,0,5472,21,9,30,1022,34,51,9,36,12,5049,18,11,29,991,39,60,12,44,15,0.5799319727891157,588,3627,434,1845,0.5508317929759704,541,2981,450,2068,2,AFC West
DEN,2010,344,471,4,12,0,5592,25,13,38,1006,40,60,11,41,12,6267,26,26,52,1040,23,55,6,35,8,0.5414634146341464,615,4021,391,1571,0.5689655172413793,522,3780,518,2487,-127,AFC West
DEN,2011,309,390,8,8,0,5087,20,11,31,1013,43,56,15,43,14,5741,24,11,35,1045,41,70,7,45,8,0.46170212765957447,470,2436,543,2651,0.5831873905429071,571,3704,474,2037,-81,AFC West
DEN,2012,481,289,13,3,0,6387,37,12,49,1066,21,42,12,46,11,4665,25,5,30,1002,52,82,7,34,15,0.6611842105263158,608,4544,458,1843,0.5279605263157895,608,3195,394,1470,192,AFC West
DEN,2013,606,399,13,3,0,7367,55,16,71,1131,20,46,11,34,10,5697,29,15,44,1061,41,79,10,47,16,0.6657060518731989,694,5468,437,1899,0.5502318392581144,647,4076,414,1621,207,AFC West
DEN,2014,482,354,12,4,0,6470,40,15,55,1042,17,40,4,37,12,4889,29,9,38,1026,41,84,5,39,16,0.6445880452342488,619,4665,423,1805,0.5859030837004405,681,3607,345,1282,128,AFC West
DEN,2015,355,296,12,4,0,5697,19,13,32,1046,39,85,7,40,23,4544,19,10,29,1020,51,115,10,36,14,0.5723172628304821,643,3970,403,1727,0.5521669341894061,623,3196,397,1348,59,AFC West
DEN,2016,333,297,9,7,0,5187,20,11,31,1004,40,93,11,42,11,5072,13,15,28,1058,42,99,10,22,13,0.5584843492586491,607,3685,397,1502,0.5195246179966044,589,2974,469,2098,36,AFC West
DEN,2017,289,382,5,11,0,5203,19,8,27,1063,53,96,10,37,22,4656,29,9,38,933,33,73,7,48,8,0.5380875202593193,617,3335,446,1868,0.5653846153846154,520,3210,413,1446,-93,AFC West
DEN,2018,329,349,6,10,0,5611,19,18,37,1003,34,90,6,34,14,5861,26,11,37,1002,44,86,9,34,17,0.5938511326860841,618,3695,385,1916,0.5983050847457627,590,3929,412,1932,-20,AFC West
CHI,2009,327,375,7,9,0,4978,27,6,33,955,34,72,5,34,25,5423,29,14,43,1019,34,79,13,45,12,0.576271186440678,590,3478,365,1500,0.605683836589698,563,3398,456,2025,-48,NFC North
CHI,2010,334,286,11,5,0,4653,23,10,33,917,55,83,10,53,20,5028,14,14,28,983,33,63,15,48,21,0.5297504798464492,521,3017,396,1636,0.5967213114754099,610,3579,373,1449,48,NFC North
CHI,2011,353,341,8,8,0,5024,18,10,28,967,49,81,9,56,18,5618,22,10,32,1041,34,60,9,54,15,0.5193798449612403,516,3011,451,2013,0.5833333333333334,660,4073,381,1545,12,NFC North
CHI,2012,375,277,10,6,0,4975,21,11,32,981,45,81,7,38,16,5061,19,6,25,1011,41,54,16,45,24,0.5415094339622641,530,2985,451,1990,0.5529225908372828,633,3419,378,1642,98,NFC North
CHI,2013,445,478,8,8,0,6128,32,13,45,1002,30,76,9,43,13,6325,25,22,47,1011,32,42,8,45,18,0.6151315789473685,608,4287,394,1841,0.5833333333333334,540,3730,471,2595,-33,NFC North
CHI,2014,319,442,5,11,0,5256,30,8,38,993,42,73,10,34,17,6057,34,12,46,987,39,73,8,33,12,0.6082949308755761,651,3793,342,1463,0.62778730703259,583,4230,404,1827,-123,NFC North
CHI,2015,335,397,6,10,0,5524,21,13,34,1020,33,67,8,32,10,5539,31,9,40,966,35,88,6,24,8,0.6007194244604317,556,3665,464,1859,0.5908256880733945,545,3593,421,1946,-62,NFC North
CHI,2016,279,399,3,13,0,5711,19,10,29,957,27,69,10,33,18,5570,22,18,40,989,37,65,3,36,8,0.5951972555746141,583,3974,374,1737,0.6074600355239786,563,3598,426,1972,-120,NFC North
CHI,2017,264,320,5,11,0,4578,13,13,26,926,39,74,10,69,11,5118,18,10,28,984,42,93,12,27,8,0.5708661417322834,508,2783,418,1795,0.6017543859649123,570,3376,414,1742,-56,NFC North
CHI,2018,421,283,12,4,0,5526,28,16,44,997,33,59,10,46,13,4801,22,5,27,1004,50,96,8,31,26,0.63003663003663,546,3570,451,1956,0.5669172932330827,665,3521,339,1280,138,NFC North
DAL,2009,361,250,11,5,0,6406,26,14,40,998,34,72,8,40,8,5071,19,7,26,966,42,89,10,26,10,0.5993091537132987,579,4287,419,2119,0.5657894736842105,608,3615,358,1456,111,NFC East
DAL,2010,394,436,6,10,0,5833,29,10,39,1023,32,72,9,30,19,5647,33,11,44,959,36,65,9,26,20,0.6291390728476821,604,4034,419,1799,0.6073298429319371,573,3895,386,1752,-42,NFC East
DAL,2011,369,347,8,8,0,6020,33,5,38,1001,39,77,9,35,12,5501,24,10,34,958,42,87,9,40,15,0.6214876033057851,605,4201,396,1819,0.5763293310463122,583,3905,375,1596,22,NFC East
DAL,2012,376,400,8,8,0,6022,29,8,37,1034,36,72,8,39,18,5693,22,17,39,973,35,65,7,29,7,0.6271676300578035,692,4733,342,1289,0.5933456561922366,541,3691,432,2002,-24,NFC East
DAL,2013,439,432,8,8,0,5486,33,12,45,947,35,50,6,28,12,6667,33,17,50,1078,34,60,11,38,15,0.6048387096774194,620,3970,327,1516,0.6171516079632465,653,4591,425,2076,7,NFC East
DAL,2014,467,352,12,4,0,6132,37,16,53,998,31,51,12,48,11,5691,22,18,40,967,28,74,12,42,17,0.6507936507936508,504,3768,494,2364,0.6352739726027398,584,4033,383,1658,115,NFC East
DAL,2015,275,374,4,12,0,5369,16,8,24,957,33,58,9,39,20,5590,19,16,35,978,31,73,2,55,8,0.599640933572711,557,3473,400,1896,0.6133828996282528,538,3638,440,1952,-99,NFC East
DAL,2016,421,306,13,3,0,6050,25,24,49,994,28,61,9,40,6,5506,25,9,34,1007,35,81,10,51,9,0.6360078277886497,511,3631,483,2419,0.6352765321375187,669,4172,338,1334,115,NFC East
DAL,2017,354,332,9,7,0,5320,22,18,40,996,32,75,6,39,10,5105,28,7,35,986,38,90,7,58,9,0.5908221797323135,523,3142,473,2178,0.62248322147651,596,3425,390,1680,22,NFC East
DAL,2018,339,324,10,6,0,5519,22,13,35,1006,56,104,9,42,7,5285,22,12,34,969,39,92,11,46,9,0.612736660929432,581,3538,425,1981,0.6349480968858131,578,3757,391,1528,15,NFC East
MIA,2009,360,390,7,9,0,5411,15,22,37,1077,34,58,9,36,17,5603,23,16,39,959,43,68,6,32,14,0.5776614310645725,573,3170,504,2241,0.530188679245283,530,3756,429,1847,-30,AFC East
MIA,2010,273,333,7,9,0,5185,17,8,25,1028,38,69,8,31,20,4967,22,8,30,969,39,63,7,52,11,0.5656565656565656,594,3524,434,1661,0.5353159851301115,538,3348,431,1619,-60,AFC East
MIA,2011,329,313,6,10,0,5089,20,11,31,978,52,83,12,39,12,5536,24,8,32,1033,42,86,1,40,16,0.5374280230326296,521,3098,457,1991,0.5564387917329093,629,3988,404,1548,16,AFC East
MIA,2012,288,317,7,9,0,5005,13,15,28,959,37,62,11,41,11,5724,18,10,28,1061,41,85,5,44,9,0.5435992578849722,539,3200,420,1805,0.5507020280811232,641,3981,420,1743,-29,AFC East
MIA,2013,317,335,8,8,0,4906,23,8,31,971,58,89,7,36,17,5659,17,14,31,1065,40,79,5,34,17,0.5508607198748043,639,3526,332,1380,0.5614617940199336,602,3644,463,2015,-18,AFC East
MIA,2014,388,373,8,8,0,5597,27,12,39,1025,47,93,7,44,11,5508,27,13,40,1014,39,65,10,37,13,0.6165884194053208,639,3704,386,1893,0.5919439579684763,571,3559,443,1949,15,AFC East
MIA,2015,310,389,6,10,0,5319,24,11,35,965,45,93,6,34,11,6038,31,13,44,1059,31,80,4,65,12,0.5791139240506329,632,3815,333,1504,0.6118881118881119,572,4000,487,2038,-79,AFC East
MIA,2016,363,380,10,6,0,5341,27,14,41,901,29,79,6,51,12,6141,30,12,42,1075,33,81,9,51,16,0.632,500,3512,401,1829,0.5894568690095847,626,3886,449,2255,-17,AFC East
MIA,2017,281,393,6,10,0,4932,24,4,28,982,33,73,7,57,17,5390,26,14,40,965,30,80,6,47,7,0.5930047694753577,629,3535,353,1397,0.6141304347826086,552,3603,413,1787,-112,AFC East
MIA,2018,319,433,7,9,0,4651,26,7,33,863,52,104,10,40,12,6278,31,17,48,1005,31,73,5,38,20,0.5805168986083499,503,2902,360,1749,0.6226765799256505,538,3934,467,2344,-114,AFC East
MIN,2009,470,312,12,4,0,6094,34,19,53,1032,34,80,10,49,7,4893,26,5,31,933,47,92,11,48,10,0.6472602739726028,584,4156,448,1938,0.5859106529209622,582,3495,351,1398,158,NFC North
MIN,2010,281,348,6,10,0,5052,14,16,30,972,35,82,11,43,25,5020,25,10,35,965,30,67,8,51,15,0.5669144981412639,538,3102,434,1950,0.599640933572711,557,3374,408,1646,-67,NFC North
MIN,2011,340,449,3,13,0,5280,20,18,38,1000,49,70,8,53,16,5744,34,10,44,1015,50,77,12,51,8,0.5134649910233393,557,2957,443,2323,0.6262798634812287,586,4019,429,1725,-109,NFC North
MIN,2012,379,348,10,6,0,5408,18,16,34,988,31,59,11,66,12,5626,28,10,38,1073,44,81,12,40,9,0.5813953488372093,516,2760,472,2648,0.5978593272171254,654,3919,419,1707,31,NFC North
MIN,2013,391,480,5,10,1,5516,18,23,41,1005,44,74,10,43,18,6384,37,14,51,1113,42,80,6,46,12,0.5508474576271186,590,3427,415,2089,0.6131386861313869,685,4595,428,1789,-89,NFC North
MIN,2014,325,343,7,9,0,5074,17,12,29,965,52,89,1,30,17,5530,26,10,36,1008,42,85,5,29,13,0.5737122557726465,563,3253,402,1821,0.6178010471204188,573,3566,435,1964,-18,NFC North
MIN,2015,365,302,11,5,0,5159,14,18,32,960,45,86,7,57,8,5524,24,7,31,1002,43,96,8,36,12,0.5903614457831325,498,2928,462,2231,0.5973377703826955,601,3764,401,1760,63,NFC North
MIN,2016,327,307,8,8,0,5060,20,9,29,995,38,92,8,46,5,5045,22,9,31,986,41,105,11,23,13,0.6592356687898089,628,3836,367,1224,0.5675213675213675,585,3327,401,1718,20,NFC North
MIN,2017,382,252,13,3,0,5740,25,15,40,1036,27,79,6,55,8,4431,13,10,23,942,37,79,4,32,12,0.6420863309352518,556,3755,480,1985,0.5519591141396933,587,3080,355,1351,130,NFC North
MIN,2018,360,341,8,7,1,5541,30,9,39,996,40,94,10,39,10,4971,15,13,28,981,50,87,7,39,12,0.6558641975308642,648,4042,348,1499,0.5737704918032787,549,3146,432,1825,19,NFC North
STL,2009,175,436,1,15,0,4474,12,4,16,992,44,92,9,40,19,5992,22,24,46,990,25,68,11,41,8,0.5343642611683849,582,2678,410,1796,0.6140350877192983,513,3766,477,2226,-261,NFC West
STL,2010,289,328,7,9,0,4837,18,9,27,1039,34,69,4,42,14,5430,22,7,29,999,43,80,10,46,13,0.5711974110032363,618,3252,421,1585,0.5429042904290429,606,3606,393,1824,-39,NFC West
STL,2011,193,407,2,14,0,4546,9,7,16,1000,55,101,12,48,9,5734,21,17,38,1004,39,75,5,48,11,0.4882943143812709,598,2863,402,1683,0.5647969052224371,517,3278,487,2456,-214,NFC West
STL,2012,299,348,7,8,1,5285,22,5,27,983,34,76,6,38,12,5493,16,18,34,1024,51,79,3,60,16,0.5684931506849316,584,3556,399,1729,0.6114864864864865,592,3619,432,1874,-49,NFC West
STL,2013,348,364,7,9,0,4899,22,10,32,953,35,68,10,41,11,5534,21,18,39,1003,53,88,13,60,14,0.5584415584415584,539,3129,414,1770,0.6195462478184991,573,3876,430,1658,-16,NFC West
STL,2014,324,354,6,10,0,5044,20,11,31,948,47,83,10,41,16,5638,18,12,30,987,41,69,11,50,12,0.5836298932384342,562,3399,386,1645,0.6360485268630849,577,3854,410,1784,-30,NFC West
STL,2015,280,330,7,9,0,4779,11,16,27,905,18,89,9,59,11,5907,21,7,28,1071,41,102,11,66,13,0.558282208588957,489,2807,416,1972,0.6293375394321766,634,4065,437,1842,-50,NFC West
LA,2016,224,394,4,12,0,4258,14,9,23,950,49,89,8,45,19,5409,32,12,44,1021,31,91,9,60,10,0.5351629502572899,583,2951,367,1307,0.6176470588235294,612,3732,409,1677,-170,NFC West
LA,2017,478,329,11,5,0,5806,28,17,45,976,28,71,10,48,7,5444,21,15,36,1010,47,96,9,33,17,0.5911602209944752,543,3836,433,1970,0.5409015025041736,599,3479,411,1965,149,NFC West
LA,2018,527,384,13,3,0,6775,32,23,55,1041,33,69,6,38,12,5748,31,12,43,953,41,99,11,29,17,0.6133333333333333,600,4513,441,2262,0.6055846422338569,573,3784,380,1964,143,NFC West
LAC,2017,355,272,9,7,0,6046,28,10,38,996,18,67,4,51,10,5233,17,11,28,992,43,77,9,44,17,0.6172006745362564,593,4431,403,1615,0.5784832451499118,567,3133,425,2100,83,AFC West
LAC,2018,428,329,12,4,0,5986,32,16,48,937,34,85,5,33,11,5347,23,11,34,973,38,77,7,35,12,0.631578947368421,551,4097,386,1889,0.6020583190394511,583,3648,390,1699,99,AFC West
