"Team","season","TOI","GP","GF","GA","G_diff","xGF","xGA","xG_diff","SF","SA","S_diff","FF","FA","F_diff","CF","CA","C_diff","Sh_perc","SV_perc","GF_perc","xGF_perc","SF_perc","FF_perc","CF_perc","PEND2","PENT2","PEND5","PENT5","PEN2_diff"
"ANA","20072008",4907.32,82,197,184,13,178.1,191.32,-13.22,2241,2300,-59,3142,3112,30,3935,3832,103,8.79,92,51.71,48.21,49.35,50.24,50.66,444,488,54,57,-44
"ANA","20082009",4987.58,82,238,235,3,213.48,213.77,-0.28,2481,2500,-19,3465,3478,-13,4336,4279,57,9.59,90.6,50.32,49.97,49.81,49.91,50.33,373,450,56,68,-77
"ANA","20092010",4795.87,82,233,243,-10,208.67,241.54,-32.87,2472,2737,-265,3422,3828,-406,4363,4771,-408,9.43,91.12,48.95,46.35,47.46,47.2,47.77,365,386,51,52,-21
"ANA","20102011",4992.72,82,235,233,2,203,240.45,-37.45,2334,2649,-315,3219,3794,-575,4093,5041,-948,10.07,91.2,50.21,45.78,46.84,45.9,44.81,327,344,43,41,-17
"ANA","20112012",4986.85,82,201,224,-23,210.59,225.21,-14.62,2292,2366,-74,3309,3413,-104,4407,4588,-181,8.77,90.53,47.29,48.32,49.21,49.23,48.99,301,316,28,25,-15
"ANA","20122013",2936.3,48,134,115,19,126.54,121.12,5.43,1347,1340,7,1871,1967,-96,2523,2743,-220,9.95,91.42,53.82,51.09,50.13,48.75,47.91,149,171,11,11,-22
"ANA","20132014",4990.88,82,263,203,60,242.59,218,24.58,2569,2354,215,3588,3436,152,4707,4678,29,10.24,91.38,56.44,52.67,52.18,51.08,50.15,310,315,23,20,-5
"ANA","20142015",5002.73,82,228,221,7,225.24,207.47,17.76,2458,2367,91,3578,3360,218,4719,4522,197,9.28,90.66,50.78,52.05,50.94,51.57,51.07,275,311,27,25,-36
"ANA","20152016",4977.03,82,215,188,27,236.15,202.97,33.18,2485,2259,226,3568,3206,362,4738,4384,354,8.65,91.68,53.35,53.78,52.38,52.67,51.94,302,343,36,31,-41
"ANA","20162017",4979.78,82,220,197,23,239.64,227.01,12.63,2426,2430,-4,3457,3511,-54,4579,4659,-80,9.07,91.89,52.76,51.35,49.96,49.61,49.57,292,322,37,37,-30
"ANA","20172018",5002.32,82,231,209,22,242.52,258.89,-16.37,2476,2717,-241,3522,3853,-331,4647,5086,-439,9.33,92.31,52.5,48.37,47.68,47.76,47.74,250,313,27,26,-63
"ANA","20182019",4872.03,82,196,247,-51,206.92,267.22,-60.3,2272,2726,-454,3278,3854,-576,4394,5050,-656,8.63,90.94,44.24,43.64,45.46,45.96,46.53,246,302,11,11,-56
"ARI","20072008",4994.93,82,209,225,-16,199.57,218.77,-19.2,2500,2518,-18,3390,3515,-125,4394,4533,-139,8.36,91.06,48.16,47.71,49.82,49.09,49.22,394,380,34,38,14
"ARI","20082009",4901.5,81,200,248,-48,185.97,214.97,-29.01,2269,2555,-286,3148,3621,-473,4157,4808,-651,8.81,90.29,44.64,46.38,47.04,46.51,46.37,392,341,53,54,51
"ARI","20092010",5032.58,82,211,196,15,199.32,204.69,-5.37,2504,2427,77,3495,3439,56,4575,4409,166,8.43,91.92,51.84,49.34,50.78,50.4,50.92,341,341,30,31,0
"ARI","20102011",4995.48,82,226,220,6,217.06,237.33,-20.27,2486,2672,-186,3518,3770,-252,4658,4826,-168,9.09,91.77,50.67,47.77,48.2,48.27,49.11,326,340,22,21,-14
"ARI","20112012",4831.95,79,202,187,15,203.62,217.32,-13.7,2340,2504,-164,3315,3525,-210,4432,4563,-131,8.63,92.53,51.93,48.37,48.31,48.46,49.27,277,279,23,24,-2
"ARI","20122013",2945.2,48,121,125,-4,123.13,129.99,-6.86,1483,1468,15,2085,2064,21,2780,2753,27,8.16,91.49,49.19,48.64,50.25,50.25,50.24,195,192,17,16,3
"ARI","20132014",5016.35,82,210,224,-14,202.97,226.25,-23.28,2498,2541,-43,3496,3506,-10,4704,4635,69,8.41,91.18,48.39,47.29,49.57,49.93,50.37,329,321,17,16,8
"ARI","20142015",4995.43,82,165,267,-102,194.76,249.09,-54.33,2393,2722,-329,3384,3790,-406,4618,5061,-443,6.9,90.19,38.19,43.88,46.78,47.17,47.71,268,318,26,26,-50
"ARI","20152016",4956.22,82,208,244,-36,200.43,224.14,-23.7,2266,2541,-275,3200,3640,-440,4357,4790,-433,9.18,90.4,46.02,47.21,47.14,46.78,47.63,343,355,22,22,-12
"ARI","20162017",4985.78,82,191,258,-67,187.91,261.32,-73.42,2281,2797,-516,3228,4037,-809,4285,5252,-967,8.37,90.78,42.54,41.83,44.92,44.43,44.93,272,301,18,19,-29
"ARI","20172018",4999.25,82,206,251,-45,213.27,248.67,-35.4,2449,2643,-194,3475,3855,-380,4788,5040,-252,8.41,90.5,45.08,46.17,48.1,47.41,48.72,282,263,15,14,19
"ARI","20182019",4980.35,82,209,220,-11,220.01,226.15,-6.14,2520,2527,-7,3526,3557,-31,4724,4855,-131,8.29,91.29,48.72,49.31,49.93,49.78,49.32,292,266,7,7,26
"ATL","20072008",5011.78,82,207,266,-59,175.49,219.35,-43.87,2115,2782,-667,2801,3687,-886,3652,4763,-1111,9.79,90.44,43.76,44.45,43.19,43.17,43.4,357,390,18,22,-33
"ATL","20082009",4981.48,82,250,279,-29,215.47,242.73,-27.26,2306,2683,-377,3155,3605,-450,4122,4727,-605,10.84,89.6,47.26,47.03,46.22,46.67,46.58,414,422,45,44,-8
"ATL","20092010",4988,82,230,250,-20,204.64,245.61,-40.97,2410,2716,-306,3251,3602,-351,4349,4671,-322,9.54,90.8,47.92,45.45,47.02,47.44,48.22,373,376,39,39,-3
"ATL","20102011",5012.82,82,218,262,-44,212.63,243.41,-30.79,2581,2638,-57,3532,3557,-25,4656,4849,-193,8.45,90.07,45.42,46.63,49.45,49.82,48.98,329,323,31,31,6
"BOS","20072008",4973.2,82,206,214,-8,173.59,200.42,-26.82,2328,2483,-155,3211,3331,-120,4164,4207,-43,8.85,91.38,49.05,46.41,48.39,49.08,49.74,362,374,46,45,-12
"BOS","20082009",4926.88,81,267,188,79,214.54,208.09,6.45,2460,2495,-35,3361,3315,46,4409,4365,44,10.85,92.46,58.68,50.76,49.65,50.34,50.25,363,353,45,42,10
"BOS","20092010",4932.53,82,196,191,5,200.76,193.03,7.73,2599,2445,154,3531,3238,293,4686,4210,476,7.54,92.19,50.65,50.98,51.53,52.16,52.68,307,316,41,42,-9
"BOS","20102011",4980.07,82,244,189,55,216.7,218.84,-2.14,2696,2683,13,3644,3619,25,4923,4791,132,9.05,92.96,56.35,49.75,50.12,50.17,50.68,300,301,68,67,-1
"BOS","20112012",4988.88,82,260,199,61,215.28,190.85,24.43,2653,2441,212,3663,3281,382,4964,4335,629,9.8,91.85,56.64,53.01,52.08,52.75,53.38,300,297,57,60,3
"BOS","20122013",2923.08,48,127,106,21,133.92,120.36,13.56,1557,1374,183,2168,1897,271,2929,2547,382,8.16,92.29,54.51,52.67,53.12,53.33,53.49,145,187,32,32,-42
"BOS","20132014",4978.82,82,258,171,87,223.33,189.36,33.97,2613,2385,228,3600,3227,373,4838,4278,560,9.87,92.83,60.14,54.12,52.28,52.73,53.07,266,305,40,41,-39
"BOS","20142015",5025.32,82,209,201,8,207.26,201.91,5.35,2546,2449,97,3550,3373,177,4817,4420,397,8.21,91.79,50.98,50.65,50.97,51.28,52.15,250,285,28,26,-35
"BOS","20152016",4978.52,82,236,228,8,211.29,221.41,-10.13,2619,2492,127,3555,3528,27,4691,4712,-21,9.01,90.85,50.86,48.83,51.24,50.19,49.89,275,319,31,31,-44
"BOS","20162017",4964.12,82,232,209,23,233.14,193.18,39.95,2721,2197,524,3793,3096,697,5014,4190,824,8.53,90.49,52.61,54.69,55.33,55.06,54.48,297,315,29,29,-18
"BOS","20172018",4982.37,82,267,211,56,248.19,208.51,39.68,2703,2400,303,3734,3333,401,4926,4405,521,9.88,91.21,55.86,54.34,52.97,52.84,52.79,290,279,24,22,11
"BOS","20182019",4983.53,82,257,212,45,230.68,215.59,15.09,2680,2416,264,3734,3326,408,4848,4376,472,9.59,91.23,54.8,51.69,52.59,52.89,52.56,294,288,24,25,6
"BUF","20072008",4981.05,82,250,233,17,205.28,188.01,17.27,2463,2315,148,3322,3205,117,4274,4234,40,10.15,89.94,51.76,52.2,51.55,50.9,50.24,417,391,18,16,26
"BUF","20082009",4898.18,82,242,229,13,195.79,196.25,-0.46,2507,2575,-68,3380,3528,-148,4424,4611,-187,9.65,91.11,51.38,49.94,49.33,48.93,48.97,411,399,23,24,12
"BUF","20092010",4791.8,82,231,201,30,208.39,212.13,-3.74,2588,2574,14,3492,3545,-53,4564,4541,23,8.93,92.19,53.47,49.56,50.14,49.62,50.13,361,343,24,23,18
"BUF","20102011",4999.08,82,240,228,12,218.96,212.22,6.74,2690,2514,176,3567,3522,45,4689,4690,-1,8.92,90.93,51.28,50.78,51.69,50.32,49.99,327,364,26,25,-37
"BUF","20112012",5010.63,82,211,223,-12,195.4,220.7,-25.3,2395,2571,-176,3288,3542,-254,4445,4617,-172,8.81,91.33,48.62,46.96,48.23,48.14,49.05,309,311,34,31,-2
"BUF","20122013",2946.13,48,118,139,-21,108.18,143.44,-35.26,1339,1606,-267,1799,2220,-421,2405,2938,-533,8.81,91.34,45.91,42.99,45.47,44.76,45.01,198,209,22,23,-11
"BUF","20132014",4894.52,82,150,243,-93,179.43,251.66,-72.23,2157,2816,-659,2935,3882,-947,3924,5120,-1196,6.95,91.37,38.17,41.62,43.37,43.05,43.39,293,306,34,33,-13
"BUF","20142015",4989.98,82,153,269,-116,165.69,251.72,-86.02,1984,2921,-937,2640,4096,-1456,3446,5630,-2184,7.71,90.79,36.26,39.69,40.45,39.19,37.97,260,297,29,28,-37
"BUF","20152016",4991.12,82,199,215,-16,201.83,211.97,-10.13,2418,2513,-95,3284,3507,-223,4325,4602,-277,8.23,91.44,48.07,48.77,49.04,48.36,48.45,288,259,21,20,29
"BUF","20162017",4984.85,82,199,231,-32,206.37,233.09,-26.73,2492,2816,-324,3384,3821,-437,4416,4942,-526,7.99,91.8,46.28,46.96,46.95,46.97,47.19,270,271,22,21,-1
"BUF","20172018",4974.03,82,198,278,-80,201.51,242.52,-41.01,2558,2683,-125,3475,3669,-194,4491,4751,-260,7.74,89.64,41.6,45.38,48.81,48.64,48.59,284,257,14,13,27
"BUF","20182019",4994.35,82,221,268,-47,214.7,237.3,-22.6,2698,2704,-6,3659,3641,18,4688,4644,44,8.19,90.09,45.19,47.5,49.94,50.12,50.24,264,247,11,11,17
"CAR","20072008",4964.43,82,250,246,4,222.46,212.51,9.95,2669,2368,301,3661,3320,341,4882,4376,506,9.37,89.61,50.4,51.14,52.99,52.44,52.73,468,407,39,39,61
"CAR","20082009",4986.05,82,236,221,15,233.38,225.54,7.85,2675,2419,256,3758,3441,317,5028,4635,393,8.82,90.86,51.64,50.85,52.51,52.2,52.03,407,339,24,24,68
"CAR","20092010",4926.68,81,224,249,-25,227.74,252.88,-25.14,2373,2536,-163,3369,3614,-245,4570,4775,-205,9.44,90.18,47.36,47.38,48.34,48.25,48.9,366,353,33,33,13
"CAR","20102011",4996.7,82,231,234,-3,230.3,247.49,-17.19,2517,2725,-208,3562,3880,-318,4935,5083,-148,9.18,91.41,49.68,48.2,48.02,47.86,49.26,400,314,24,24,86
"CAR","20112012",4988.67,82,212,237,-25,236.92,249.7,-12.78,2497,2653,-156,3513,3736,-223,4745,4974,-229,8.49,91.07,47.22,48.69,48.49,48.46,48.82,350,308,18,19,42
"CAR","20122013",2898.4,48,127,159,-32,143.28,152.64,-9.37,1545,1548,-3,2187,2161,26,2977,2828,149,8.22,89.73,44.41,48.42,49.95,50.3,51.28,188,184,19,19,4
"CAR","20132014",4979.15,82,205,226,-21,230.38,232.73,-2.35,2561,2537,24,3619,3598,21,4929,4694,235,8,91.09,47.56,49.75,50.24,50.15,51.22,321,286,6,6,35
"CAR","20142015",4999.02,82,183,219,-36,223.51,211.72,11.79,2524,2237,287,3549,3221,328,4848,4311,537,7.25,90.21,45.52,51.35,53.01,52.42,52.93,273,221,17,17,52
"CAR","20152016",5004.65,82,196,221,-25,224.11,215.22,8.9,2450,2262,188,3480,3249,231,4679,4229,450,8,90.23,47,51.01,51.99,51.72,52.53,275,242,11,10,33
"CAR","20162017",4993.07,82,212,230,-18,238.01,218.6,19.41,2493,2320,173,3515,3300,215,4780,4362,418,8.5,90.09,47.96,52.13,51.8,51.58,52.29,253,222,6,6,31
"CAR","20172018",4981.95,82,225,253,-28,257.13,219.99,37.14,2781,2368,413,3929,3315,614,5318,4321,997,8.09,89.32,47.07,53.89,54.01,54.24,55.17,263,217,8,8,46
"CAR","20182019",4957.92,82,243,221,22,296.24,226.38,69.87,2822,2343,479,4036,3311,725,5350,4355,995,8.61,90.57,52.37,56.68,54.64,54.93,55.13,285,278,8,8,7
"CBJ","20072008",4925.52,81,186,207,-21,188.05,169.23,18.81,2355,2213,142,3152,2922,230,4132,3785,347,7.9,90.65,47.33,52.63,51.55,51.89,52.19,420,440,54,57,-20
"CBJ","20082009",5009.65,82,220,223,-3,191.18,189.94,1.25,2371,2281,90,3229,3108,121,4231,4130,101,9.28,90.22,49.66,50.16,50.97,50.95,50.6,381,405,52,50,-24
"CBJ","20092010",4937.35,81,211,249,-38,186.91,206.16,-19.25,2317,2474,-157,3062,3391,-329,4015,4405,-390,9.11,89.94,45.87,47.55,48.36,47.45,47.68,346,376,45,46,-30
"CBJ","20102011",5011.55,82,210,250,-40,217.07,211.23,5.83,2506,2447,59,3460,3310,150,4612,4424,188,8.38,89.78,45.65,50.68,50.6,51.11,51.04,365,364,49,51,1
"CBJ","20112012",4973.75,82,198,257,-59,206.23,201.91,4.32,2453,2537,-84,3295,3348,-53,4325,4402,-77,8.07,89.87,43.52,50.53,49.16,49.6,49.56,359,315,51,53,44
"CBJ","20122013",2949.87,48,115,115,0,102.57,112.1,-9.53,1283,1436,-153,1736,1932,-196,2416,2559,-143,8.96,91.99,50,47.78,47.19,47.33,48.56,184,176,27,29,8
"CBJ","20132014",4876.75,82,225,214,11,204.76,197.55,7.21,2430,2524,-94,3335,3343,-8,4443,4424,19,9.26,91.52,51.25,50.9,49.05,49.94,50.11,316,321,34,35,-5
"CBJ","20142015",4998.12,82,227,248,-21,210.48,238.53,-28.05,2366,2742,-376,3190,3667,-477,4215,4747,-532,9.59,90.96,47.79,46.88,46.32,46.52,47.03,290,348,32,31,-58
"CBJ","20152016",4985.28,82,213,248,-35,238.12,240.14,-2.02,2387,2549,-162,3259,3539,-280,4358,4799,-441,8.92,90.27,46.2,49.79,48.36,47.94,47.59,305,329,33,36,-24
"CBJ","20162017",4969.68,82,247,193,54,232.17,239.64,-7.47,2540,2488,52,3419,3465,-46,4564,4644,-80,9.72,92.24,56.14,49.21,50.52,49.67,49.57,273,279,20,21,-6
"CBJ","20172018",4995.43,82,236,226,10,242.73,242.17,0.57,2761,2568,193,3804,3482,322,4932,4700,232,8.55,91.2,51.08,50.06,51.81,52.21,51.2,260,240,9,9,20
"CBJ","20182019",4953.42,82,256,231,25,232.84,222.79,10.05,2592,2418,174,3566,3327,239,4573,4403,170,9.88,90.45,52.57,51.1,51.74,51.73,50.95,244,222,11,10,22
"CGY","20072008",4913.27,81,223,220,3,209.33,184.62,24.71,2280,2309,-29,3216,3126,90,4176,3885,291,9.78,90.47,50.34,53.14,49.68,50.71,51.8,400,442,67,65,-42
"CGY","20082009",4900.18,81,248,242,6,218.86,207.7,11.16,2611,2402,209,3651,3328,323,4829,4106,723,9.5,89.93,50.61,51.31,52.08,52.31,54.05,423,411,56,51,12
"CGY","20092010",4979.9,82,201,203,-2,184.33,187.78,-3.45,2350,2372,-22,3355,3338,17,4571,4400,171,8.55,91.44,49.75,49.54,49.77,50.13,50.95,309,352,71,69,-43
"CGY","20102011",5018.72,82,241,230,11,211.84,184.23,27.61,2502,2338,164,3549,3257,292,4742,4466,276,9.63,90.16,51.17,53.49,51.69,52.15,51.5,354,318,34,34,36
"CGY","20112012",5008.08,82,199,217,-18,198.89,215.13,-16.24,2259,2529,-270,3083,3551,-468,4203,4709,-506,8.81,91.42,47.84,48.04,47.18,46.47,47.16,304,315,29,30,-11
"CGY","20122013",2901.17,48,128,157,-29,118.4,125.49,-7.09,1292,1413,-121,1810,1979,-169,2439,2678,-239,9.91,88.89,44.91,48.55,47.76,47.77,47.66,173,170,23,22,3
"CGY","20132014",4995.05,82,202,238,-36,192.07,216.48,-24.41,2199,2346,-147,3124,3320,-196,4243,4742,-499,9.19,89.86,45.91,47.01,48.38,48.48,47.22,288,274,28,27,14
"CGY","20142015",4990.97,82,237,213,24,203.23,209.55,-6.33,2252,2392,-140,3142,3438,-296,4387,4995,-608,10.52,91.1,52.67,49.23,48.49,47.75,46.76,301,226,22,23,75
"CGY","20152016",4973.22,82,229,257,-28,219.38,220.89,-1.51,2398,2376,22,3294,3382,-88,4532,4702,-170,9.55,89.18,47.12,49.83,50.23,49.34,49.08,307,270,19,19,37
"CGY","20162017",4973.93,82,222,219,3,205.52,214.22,-8.7,2389,2356,33,3302,3317,-15,4497,4428,69,9.29,90.7,50.34,48.96,50.35,49.89,50.39,311,333,31,31,-22
"CGY","20172018",4979.67,82,216,243,-27,251.97,238.79,13.17,2759,2554,205,3991,3606,385,5334,4706,628,7.83,90.49,47.06,51.34,51.93,52.53,53.13,317,319,27,32,-2
"CGY","20182019",4950.92,82,289,223,66,255.27,213.46,41.8,2654,2301,353,3691,3241,450,4966,4274,692,10.89,90.31,56.45,54.46,53.56,53.25,53.74,307,282,12,9,25
"CHI","20072008",4920.95,81,234,230,4,188.22,199.93,-11.72,2270,2322,-52,2920,2973,-53,3720,3851,-131,10.31,90.09,50.43,48.49,49.43,49.55,49.13,430,447,53,56,-17
"CHI","20082009",4995.63,82,260,209,51,214.39,197.73,16.66,2683,2344,339,3546,3049,497,4535,3895,640,9.69,91.08,55.44,52.02,53.37,53.77,53.8,403,374,54,54,29
"CHI","20092010",5012.57,82,262,203,59,235.63,184.04,51.58,2799,2058,741,3781,2799,982,4979,3866,1113,9.36,90.14,56.34,56.15,57.63,57.46,56.29,350,311,32,33,39
"CHI","20102011",5000.23,82,252,220,32,220.08,201.01,19.07,2635,2353,282,3563,3180,383,4726,4323,403,9.56,90.65,53.39,52.26,52.83,52.84,52.23,304,282,27,28,22
"CHI","20112012",5016.2,82,241,231,10,230.96,206.3,24.67,2582,2343,239,3504,3200,304,4694,4229,465,9.33,90.14,51.06,52.82,52.43,52.27,52.61,308,264,41,40,44
"CHI","20122013",2945.42,48,149,97,52,126.39,109.24,17.15,1494,1258,236,1994,1693,301,2686,2345,341,9.97,92.29,60.57,53.64,54.29,54.08,53.39,175,167,15,13,8
"CHI","20132014",5007.45,82,261,212,49,237.43,192.5,44.93,2717,2229,488,3638,3013,625,4906,4036,870,9.61,90.49,55.18,55.23,54.93,54.7,54.86,286,278,15,15,8
"CHI","20142015",4994.18,82,220,186,34,237.12,210.55,26.57,2777,2477,300,3713,3276,437,5109,4316,793,7.92,92.49,54.19,52.97,52.85,53.13,54.21,301,249,16,15,52
"CHI","20152016",4972.58,82,234,207,27,220.95,228.74,-7.79,2497,2527,-30,3346,3399,-53,4591,4532,59,9.37,91.81,53.06,49.13,49.7,49.61,50.32,285,262,12,11,23
"CHI","20162017",4979.98,82,240,212,28,224.93,223.84,1.1,2509,2574,-65,3348,3426,-78,4633,4652,-19,9.57,91.76,53.1,50.12,49.36,49.42,49.9,255,237,13,14,18
"CHI","20172018",4966.3,82,228,254,-26,243.1,251.01,-7.91,2794,2697,97,3741,3637,104,5320,4836,484,8.16,90.58,47.3,49.2,50.88,50.7,52.38,304,266,12,11,38
"CHI","20182019",4979.32,82,267,291,-24,229.56,273.93,-44.38,2671,2851,-180,3512,3758,-246,4770,4873,-103,10,89.79,47.85,45.59,48.37,48.31,49.47,255,241,7,10,14
"COL","20072008",4988.2,82,224,216,8,203.81,192.46,11.35,2349,2237,112,3074,3131,-57,3941,4212,-271,9.54,90.34,50.91,51.43,51.22,49.54,48.34,368,329,46,41,39
"COL","20082009",4989.5,82,190,253,-63,182.28,192.38,-10.1,2359,2376,-17,3187,3392,-205,4184,4709,-525,8.05,89.35,42.89,48.65,49.82,48.44,47.05,355,362,46,44,-7
"COL","20092010",4995.27,82,237,228,9,205.95,217.31,-11.36,2288,2627,-339,3053,3617,-564,3994,4843,-849,10.36,91.32,50.97,48.66,46.55,45.77,45.2,350,346,53,55,4
"COL","20102011",4990.48,82,221,286,-65,207.23,232,-24.77,2394,2608,-214,3245,3639,-394,4254,4815,-561,9.23,89.03,43.59,47.18,47.86,47.14,46.91,309,361,38,37,-52
"COL","20112012",5006.52,82,199,218,-19,205.7,215.09,-9.39,2584,2427,157,3457,3407,50,4683,4518,165,7.7,91.02,47.72,48.88,51.57,50.36,50.9,256,311,33,33,-55
"COL","20122013",2930.47,48,114,150,-36,115.73,139.56,-23.83,1415,1508,-93,1923,2100,-177,2583,2883,-300,8.06,90.05,43.18,45.33,48.41,47.8,47.26,159,204,22,21,-45
"COL","20132014",5002.97,82,245,216,29,211.59,235.41,-23.82,2421,2678,-257,3249,3741,-492,4311,4943,-632,10.12,91.93,53.15,47.34,47.48,46.48,46.59,286,279,29,30,7
"COL","20142015",5014.88,82,209,223,-14,190.12,241.26,-51.14,2286,2719,-433,3053,3791,-738,4087,5182,-1095,9.14,91.8,48.38,44.07,45.67,44.61,44.09,283,268,28,29,15
"COL","20152016",4858.47,82,212,240,-28,193.88,242.4,-48.53,2349,2650,-301,3169,3704,-535,4189,5105,-916,9.03,90.94,46.9,44.44,46.99,46.11,45.07,302,287,21,21,15
"COL","20162017",4953.78,82,165,276,-111,179.71,217.97,-38.26,2304,2603,-299,3215,3510,-295,4345,4586,-241,7.16,89.4,37.41,45.19,46.95,47.81,48.65,271,301,22,22,-30
"COL","20172018",4962.18,82,255,236,19,210.67,234.79,-24.12,2434,2732,-298,3323,3777,-454,4505,5076,-571,10.48,91.36,51.93,47.29,47.12,46.8,47.02,331,307,9,11,24
"COL","20182019",4972.7,82,258,244,14,223,226.05,-3.04,2676,2618,58,3547,3538,9,4762,4861,-99,9.64,90.68,51.39,49.66,50.55,50.06,49.49,320,303,18,16,17
"DAL","20072008",5048.65,82,237,204,33,188.22,183.79,4.44,2187,2137,50,3080,3003,77,4055,3796,259,10.84,90.45,53.74,50.6,50.58,50.63,51.65,393,394,44,45,-1
"DAL","20082009",5004.55,82,224,251,-27,192.66,199.93,-7.27,2369,2304,65,3381,3261,120,4331,4243,88,9.46,89.11,47.16,49.07,50.7,50.9,50.51,409,392,41,40,17
"DAL","20092010",4957.97,81,226,241,-15,210,204.79,5.21,2496,2538,-42,3475,3590,-115,4546,4730,-184,9.05,90.5,48.39,50.63,49.58,49.19,49.01,366,317,44,50,49
"DAL","20102011",5002.2,82,222,226,-4,204.19,211.8,-7.61,2269,2504,-235,3333,3488,-155,4440,4692,-252,9.78,90.97,49.55,49.09,47.54,48.86,48.62,365,333,48,51,32
"DAL","20112012",4988.98,82,204,218,-14,188.41,215.75,-27.34,2315,2527,-212,3321,3523,-202,4475,4785,-310,8.81,91.37,48.34,46.62,47.81,48.52,48.33,309,366,26,25,-57
"DAL","20122013",2906.1,48,128,141,-13,123.93,144,-20.06,1261,1489,-228,1840,2119,-279,2577,2790,-213,10.15,90.53,47.58,46.25,45.85,46.48,48.02,199,208,26,24,-9
"DAL","20132014",4991.33,82,231,222,9,251.13,235.95,15.18,2599,2492,107,3706,3536,170,4954,4746,208,8.89,91.09,50.99,51.56,51.05,51.17,51.07,342,317,23,22,25
"DAL","20142015",4977.63,82,257,257,0,252.2,232.74,19.47,2558,2454,104,3749,3461,288,5104,4708,396,10.05,89.53,50,52.01,51.04,52,52.02,322,292,28,28,30
"DAL","20152016",4968.4,82,265,228,37,259.64,228.79,30.85,2626,2372,254,3747,3438,309,5090,4662,428,10.09,90.39,53.75,53.16,52.54,52.15,52.19,297,285,21,21,12
"DAL","20162017",4960.12,82,222,260,-38,241.94,248.64,-6.71,2505,2442,63,3612,3494,118,4889,4824,65,8.86,89.35,46.06,49.32,50.64,50.83,50.33,282,276,36,34,6
"DAL","20172018",4981.22,82,231,222,9,243.04,215.27,27.78,2561,2444,117,3521,3393,128,4814,4665,149,9.02,90.92,50.99,53.03,51.17,50.93,50.79,286,318,26,27,-32
"DAL","20182019",4962.6,82,209,200,9,231.25,222.93,8.33,2520,2591,-71,3375,3578,-203,4551,4869,-318,8.29,92.28,51.1,50.92,49.31,48.54,48.31,246,274,12,11,-28
"DET","20072008",5045.2,82,252,179,73,229.51,169.77,59.74,2820,1929,891,3855,2653,1202,4870,3362,1508,8.94,90.72,58.47,57.48,59.38,59.23,59.16,437,406,18,18,31
"DET","20082009",4927.73,81,285,237,48,231.31,189.57,41.74,2926,2242,684,3975,3025,950,5096,3754,1342,9.74,89.43,54.6,54.96,56.62,56.79,57.58,395,367,12,11,28
"DET","20092010",5015.12,82,223,207,16,226.74,186.69,40.05,2736,2413,323,3829,3248,581,5014,4162,852,8.15,91.42,51.86,54.84,53.14,54.1,54.64,347,307,16,16,40
"DET","20102011",5004.6,82,257,237,20,236.39,213.98,22.41,2755,2512,243,3870,3425,445,4999,4342,657,9.33,90.57,52.02,52.49,52.31,53.05,53.52,331,325,13,12,6
"DET","20112012",4999.3,82,239,200,39,230.92,196.7,34.22,2638,2212,426,3635,3032,603,4786,4004,782,9.06,90.96,54.44,54,54.39,54.52,54.45,321,297,15,14,24
"DET","20122013",2927.73,48,122,110,12,130.67,115.9,14.77,1448,1322,126,2060,1780,280,2735,2340,395,8.43,91.68,52.59,53,52.27,53.65,53.89,200,179,9,10,21
"DET","20132014",5026.45,82,217,221,-4,206.78,207.08,-0.3,2455,2401,54,3377,3198,179,4359,4212,147,8.84,90.8,49.54,49.96,50.56,51.36,50.86,312,326,5,3,-14
"DET","20142015",5017.65,82,231,211,20,223.64,205.79,17.85,2429,2322,107,3350,3138,212,4499,4046,453,9.51,90.91,52.26,52.08,51.13,51.63,52.65,345,338,6,6,7
"DET","20152016",4992.85,82,209,219,-10,223.52,226.51,-2.98,2433,2439,-6,3371,3331,40,4459,4240,219,8.59,91.02,48.83,49.67,49.94,50.3,51.26,322,332,7,8,-10
"DET","20162017",5018.57,82,198,244,-46,209.96,233.39,-23.42,2335,2509,-174,3270,3481,-211,4286,4547,-261,8.48,90.28,44.8,47.36,48.2,48.44,48.52,297,279,23,23,18
"DET","20172018",4983.85,82,212,254,-42,217.51,240.69,-23.18,2491,2612,-121,3471,3598,-127,4501,4766,-265,8.51,90.28,45.49,47.47,48.81,49.1,48.57,260,280,20,18,-20
"DET","20182019",4996.98,82,224,272,-48,211.69,262.09,-50.4,2394,2760,-366,3291,3823,-532,4368,4926,-558,9.36,90.14,45.16,44.68,46.45,46.26,47,249,274,15,15,-25
"EDM","20072008",4935.35,82,220,247,-27,187.38,218.35,-30.98,2156,2573,-417,3031,3594,-563,4004,4737,-733,10.2,90.4,47.11,46.18,45.59,45.75,45.81,380,402,49,49,-22
"EDM","20082009",4885.02,82,228,244,-16,202.95,224.76,-21.81,2303,2668,-365,3215,3697,-482,4273,4771,-498,9.9,90.85,48.31,47.45,46.33,46.51,47.25,409,395,64,59,14
"EDM","20092010",4997.1,82,206,278,-72,194.22,236.78,-42.57,2321,2717,-396,3213,3874,-661,4243,5179,-936,8.88,89.77,42.56,45.06,46.07,45.34,45.03,354,361,57,57,-7
"EDM","20102011",4989.55,82,191,260,-69,198.22,251.91,-53.69,2189,2597,-408,3029,3641,-612,4180,4860,-680,8.73,89.99,42.35,44.04,45.74,45.41,46.24,353,372,53,55,-19
"EDM","20112012",4987.33,82,207,232,-25,202.79,250.38,-47.59,2186,2517,-331,3061,3495,-434,4090,4734,-644,9.47,90.78,47.15,44.75,46.48,46.69,46.35,298,332,25,26,-34
"EDM","20122013",2923.7,48,123,131,-8,115.12,147.77,-32.65,1285,1572,-287,1767,2189,-422,2344,2942,-598,9.57,91.67,48.43,43.79,44.98,44.67,44.34,189,196,13,14,-7
"EDM","20132014",4981.9,82,199,267,-68,205.99,255.29,-49.3,2209,2696,-487,3046,3833,-787,4101,5085,-984,9.01,90.1,42.7,44.66,45.04,44.28,44.64,336,339,36,35,-3
"EDM","20142015",5004.33,82,193,276,-83,203.8,236.2,-32.4,2331,2464,-133,3268,3487,-219,4492,4692,-200,8.28,88.8,41.15,46.32,48.61,48.38,48.91,262,247,30,30,15
"EDM","20152016",4981.87,82,199,242,-43,215.39,240.34,-24.95,2387,2549,-162,3283,3549,-266,4513,4782,-269,8.34,90.51,45.12,47.26,48.36,48.05,48.55,273,292,24,24,-19
"EDM","20162017",4991.08,82,243,207,36,252.27,231.98,20.28,2550,2418,132,3504,3329,175,4705,4623,82,9.53,91.44,54,52.09,51.33,51.28,50.44,282,260,32,29,22
"EDM","20172018",4976.47,82,229,262,-33,255.55,254.35,1.19,2741,2635,106,3787,3579,208,5027,4853,174,8.35,90.06,46.64,50.12,50.99,51.41,50.88,236,265,25,26,-29
"EDM","20182019",4967.63,82,229,271,-42,221,247.94,-26.94,2392,2599,-207,3280,3551,-271,4425,4725,-300,9.57,89.57,45.8,47.13,47.93,48.02,48.36,263,281,12,12,-18
"FLA","20072008",4987.97,82,211,220,-9,191.31,219.63,-28.32,2548,2752,-204,3429,3709,-280,4413,4689,-276,8.28,92.01,48.96,46.55,48.08,48.04,48.48,339,404,35,28,-65
"FLA","20082009",4998.32,82,231,223,8,208.49,238.5,-30.01,2412,2844,-432,3322,3883,-561,4399,4988,-589,9.58,92.16,50.88,46.64,45.89,46.11,46.86,339,344,31,27,-5
"FLA","20092010",5008.17,82,202,234,-32,188.75,222.84,-34.09,2331,2802,-471,3228,3827,-599,4255,5230,-975,8.67,91.65,46.33,45.86,45.41,45.75,44.86,339,313,42,43,26
"FLA","20102011",5004.08,82,191,222,-31,208.99,219.45,-10.46,2493,2610,-117,3441,3609,-168,4609,4734,-125,7.66,91.49,46.25,48.78,48.85,48.81,49.33,285,285,22,22,0
"FLA","20112012",5025.82,82,197,216,-19,194.07,211.17,-17.09,2433,2505,-72,3350,3391,-41,4443,4433,10,8.1,91.38,47.7,47.89,49.27,49.7,50.06,312,272,29,27,40
"FLA","20122013",2914.78,48,109,170,-61,115.07,134.36,-19.28,1401,1504,-103,1905,2047,-142,2511,2652,-141,7.78,88.7,39.07,46.13,48.23,48.2,48.63,167,168,18,18,-1
"FLA","20132014",4996.87,82,188,262,-74,200.12,230.31,-30.18,2451,2551,-100,3404,3420,-16,4467,4402,65,7.67,89.73,41.78,46.49,49,49.88,50.37,305,291,24,23,14
"FLA","20142015",5022.82,82,198,213,-15,202.9,196.56,6.34,2517,2424,93,3397,3332,65,4455,4333,122,7.87,91.21,48.18,50.79,50.94,50.48,50.69,302,311,14,14,-9
"FLA","20152016",4986.23,82,232,200,32,215.75,202.16,13.59,2360,2417,-57,3216,3313,-97,4104,4255,-151,9.83,91.73,53.7,51.63,49.4,49.26,49.1,331,325,27,26,6
"FLA","20162017",5007.43,82,205,231,-26,213.62,224.87,-11.25,2644,2596,48,3618,3444,174,4669,4363,306,7.75,91.1,47.02,48.72,50.46,51.23,51.69,325,313,25,24,12
"FLA","20172018",4972.53,82,245,243,2,240.46,240.32,0.14,2823,2838,-15,3853,3788,65,4941,4960,-19,8.68,91.44,50.2,50.01,49.87,50.43,49.9,295,279,48,49,16
"FLA","20182019",4899.23,82,264,273,-9,233.13,237.38,-4.25,2704,2517,187,3660,3498,162,4745,4636,109,9.76,89.15,49.16,49.55,51.79,51.13,50.58,299,259,16,14,40
"L.A","20072008",4876.92,82,226,263,-37,210.99,237.49,-26.5,2349,2625,-276,3293,3706,-413,4290,4752,-462,9.62,89.98,46.22,47.05,47.23,47.05,47.45,409,350,21,19,59
"L.A","20082009",4802.32,82,202,226,-24,209.06,201.91,7.14,2383,2302,81,3497,3337,160,4589,4377,212,8.48,90.18,47.2,50.87,50.86,51.17,51.18,420,417,46,46,3
"L.A","20092010",4919.5,82,231,211,20,198.44,199.85,-1.41,2389,2260,129,3405,3277,128,4393,4267,126,9.67,90.66,52.26,49.82,51.39,50.96,50.73,358,354,37,37,4
"L.A","20102011",4993.75,82,209,196,13,202.48,186.98,15.5,2363,2288,75,3444,3254,190,4653,4286,367,8.84,91.43,51.6,51.99,50.81,51.42,52.05,319,301,45,45,18
"L.A","20112012",5018.43,82,188,170,18,221.72,195.66,26.06,2509,2248,261,3632,3275,357,4882,4244,638,7.49,92.44,52.51,53.12,52.74,52.58,53.5,332,335,33,33,-3
"L.A","20122013",2917.15,48,131,114,17,131.01,108.05,22.97,1431,1198,233,2087,1719,368,2797,2230,567,9.15,90.48,53.47,54.8,54.43,54.83,55.64,183,182,17,17,1
"L.A","20132014",5001.38,82,198,168,30,235.04,194.39,40.64,2595,2150,445,3783,3105,678,5067,4032,1035,7.63,92.19,54.1,54.73,54.69,54.92,55.69,330,343,27,27,-13
"L.A","20142015",4990.72,82,218,197,21,219.12,196.49,22.63,2536,2215,321,3645,3158,487,4889,4150,739,8.6,91.11,52.53,52.72,53.38,53.58,54.09,290,277,22,23,13
"L.A","20152016",4984.62,82,223,192,31,232.88,217.33,15.55,2625,2255,370,3847,3174,673,5133,4201,932,8.5,91.49,53.73,51.73,53.79,54.79,54.99,274,317,28,28,-43
"L.A","20162017",4978.48,82,199,201,-2,227.39,203.88,23.52,2554,2120,434,3690,3062,628,5011,4139,872,7.79,90.52,49.75,52.73,54.64,54.65,54.77,268,271,31,29,-3
"L.A","20172018",4982.48,82,237,202,35,225.66,238.19,-12.53,2545,2537,8,3556,3597,-41,4739,4795,-56,9.31,92.04,53.99,48.65,50.08,49.71,49.71,268,291,20,19,-23
"L.A","20182019",4980.73,82,199,259,-60,208.59,230.48,-21.89,2359,2578,-219,3338,3673,-335,4492,4843,-351,8.44,89.95,43.45,47.51,47.78,47.61,48.12,251,259,15,15,-8
"MIN","20072008",4938.5,81,219,210,9,165.08,176.62,-11.54,2194,2442,-248,3113,3324,-211,4075,4226,-151,9.98,91.4,51.05,48.31,47.33,48.36,49.09,385,376,41,43,9
"MIN","20082009",4986.58,82,214,197,17,177.11,189.48,-12.37,2258,2518,-260,3165,3467,-302,4147,4500,-353,9.48,92.18,52.07,48.31,47.28,47.72,47.96,369,330,36,37,39
"MIN","20092010",4994.53,82,214,239,-25,191.07,186,5.08,2266,2415,-149,3193,3333,-140,4205,4429,-224,9.44,90.1,47.24,50.67,48.41,48.93,48.7,351,351,31,28,0
"MIN","20102011",4985.2,82,203,228,-25,181.37,213.98,-32.61,2148,2625,-477,3011,3635,-624,4008,4764,-756,9.45,91.31,47.1,45.88,45,45.31,45.69,323,348,32,31,-25
"MIN","20112012",4970.63,81,165,213,-48,192.96,214.36,-21.4,2150,2543,-393,2978,3628,-650,4003,4958,-955,7.67,91.62,43.65,47.37,45.81,45.08,44.67,303,327,41,41,-24
"MIN","20122013",2919.78,48,118,125,-7,121.01,98.72,22.29,1382,1299,83,1876,1810,66,2511,2424,87,8.54,90.38,48.56,55.07,51.55,50.9,50.88,176,160,25,24,16
"MIN","20132014",4920.05,82,199,198,1,183.08,182.58,0.5,2181,2273,-92,3041,3188,-147,4078,4314,-236,9.12,91.29,50.13,50.07,48.97,48.82,48.59,290,289,25,25,1
"MIN","20142015",4973.47,82,227,198,29,219.04,177.79,41.25,2522,2266,256,3477,3177,300,4593,4410,183,9,91.26,53.41,55.2,52.67,52.25,51.02,282,272,23,24,10
"MIN","20152016",4978.5,82,213,204,9,208.04,194.67,13.37,2375,2347,28,3277,3351,-74,4379,4560,-181,8.97,91.31,51.08,51.66,50.3,49.44,48.99,297,244,11,9,53
"MIN","20162017",4967.38,82,263,206,57,231.64,189.8,41.84,2528,2465,63,3446,3446,0,4568,4607,-39,10.4,91.64,56.08,54.96,50.63,50,49.79,263,252,20,19,11
"MIN","20172018",4978.93,82,250,229,21,227.3,201.39,25.92,2477,2569,-92,3342,3634,-292,4358,4929,-571,10.09,91.09,52.19,53.02,49.09,47.91,46.93,270,300,11,12,-30
"MIN","20182019",4968.1,82,210,233,-23,220.89,203.76,17.13,2568,2419,149,3531,3424,107,4705,4645,60,8.18,90.37,47.4,52.02,51.49,50.77,50.32,269,275,16,18,-6
"MTL","20072008",4994.87,82,257,216,41,200.56,209.45,-8.89,2383,2589,-206,3307,3646,-339,4452,4989,-537,10.78,91.66,54.33,48.92,47.93,47.56,47.16,440,404,32,31,36
"MTL","20082009",4906.72,82,242,240,2,221.52,226.01,-4.49,2461,2601,-140,3396,3601,-205,4660,4917,-257,9.83,90.77,50.21,49.5,48.62,48.54,48.66,450,442,44,46,8
"MTL","20092010",4815.97,82,210,218,-8,204.57,222.73,-18.17,2345,2634,-289,3303,3661,-358,4488,5005,-517,8.96,91.72,49.07,47.88,47.1,47.43,47.28,321,377,33,29,-56
"MTL","20102011",4973.98,82,213,206,7,215.17,223.11,-7.94,2602,2538,64,3614,3464,150,4849,4736,113,8.19,91.88,50.84,49.09,50.62,51.06,50.59,342,383,32,31,-41
"MTL","20112012",5017.93,82,207,214,-7,205.13,210.46,-5.33,2339,2432,-93,3240,3395,-155,4473,4735,-262,8.85,91.2,49.17,49.36,49.03,48.83,48.58,355,370,23,23,-15
"MTL","20122013",2917.87,48,146,124,22,130.19,107.33,22.86,1468,1294,174,2048,1786,262,2809,2488,321,9.95,90.42,54.07,54.81,53.15,53.42,53.03,239,207,23,25,32
"MTL","20132014",4991.65,82,209,201,8,213.1,225.69,-12.59,2331,2541,-210,3273,3521,-248,4452,5012,-560,8.97,92.09,50.98,48.57,47.84,48.17,47.04,344,345,40,39,-1
"MTL","20142015",5007.15,82,214,184,30,205.92,216.38,-10.46,2334,2470,-136,3239,3415,-176,4527,4821,-294,9.17,92.55,53.77,48.76,48.58,48.68,48.43,289,303,25,25,-14
"MTL","20152016",4973.8,82,216,233,-17,220.01,218.3,1.71,2505,2408,97,3433,3305,128,4713,4449,264,8.62,90.32,48.11,50.2,50.99,50.95,51.44,310,291,15,16,19
"MTL","20162017",4987.37,82,223,198,25,213.34,209.17,4.17,2460,2429,31,3448,3271,177,4735,4484,251,9.07,91.85,52.97,50.49,50.32,51.32,51.36,270,291,20,19,-21
"MTL","20172018",4979.68,82,207,258,-51,246.67,243.38,3.29,2687,2650,37,3641,3663,-22,5000,5014,-14,7.7,90.26,44.52,50.34,50.35,49.85,49.93,280,299,17,16,-19
"MTL","20182019",4957.72,82,246,236,10,242.37,223.67,18.71,2795,2550,245,3831,3458,373,5278,4628,650,8.8,90.75,51.04,52.01,52.29,52.56,53.28,271,276,13,13,-5
"N.J","20072008",5002.25,82,198,193,5,197.63,180.03,17.6,2362,2257,105,3269,3039,230,4268,3868,400,8.38,91.45,50.64,52.33,51.14,51.82,52.46,354,349,39,41,5
"N.J","20082009",4992.1,82,238,207,31,232.37,194.14,38.23,2698,2415,283,3626,3204,422,4690,4174,516,8.82,91.43,53.48,54.48,52.77,53.09,52.91,355,369,49,52,-14
"N.J","20092010",4990,82,216,186,30,204.51,173.64,30.87,2459,2213,246,3274,2961,313,4217,3924,293,8.78,91.6,53.73,54.08,52.63,52.51,51.8,308,272,40,46,36
"N.J","20102011",4975.87,82,171,207,-36,184.94,177.44,7.5,2344,2152,192,3179,2887,292,4149,3762,387,7.3,90.38,45.24,51.03,52.14,52.41,52.45,259,264,31,31,-5
"N.J","20112012",5013.52,82,216,205,11,205.3,185.06,20.24,2253,2200,53,3015,2912,103,3946,3840,106,9.59,90.68,51.31,52.59,50.6,50.87,50.68,298,284,35,35,14
"N.J","20122013",2937.75,48,110,122,-12,124.3,102.82,21.49,1363,1110,253,1921,1488,433,2566,2003,563,8.07,89.01,47.41,54.73,55.12,56.35,56.16,210,199,14,15,11
"N.J","20132014",5014.63,82,197,195,2,196.82,179.15,17.68,2200,2089,111,3032,2800,232,4045,3649,396,8.95,90.67,50.26,52.35,51.29,51.99,52.57,263,291,10,9,-28
"N.J","20142015",4998.07,82,176,209,-33,181.61,216.89,-35.28,2009,2518,-509,2785,3348,-563,3703,4390,-687,8.76,91.7,45.71,45.57,44.38,45.41,45.76,251,302,20,20,-51
"N.J","20152016",4991.3,82,182,202,-20,187.97,215.03,-27.06,2001,2348,-347,2779,3181,-402,3592,4235,-643,9.1,91.4,47.4,46.64,46.01,46.63,45.89,299,304,19,22,-5
"N.J","20162017",4987.6,82,180,241,-61,200.19,229.52,-29.34,2279,2573,-294,3129,3516,-387,4042,4546,-504,7.9,90.63,42.76,46.59,46.97,47.09,47.07,294,299,24,26,-5
"N.J","20172018",4989.83,82,243,240,3,232.65,235.37,-2.73,2599,2616,-17,3561,3671,-110,4564,4846,-282,9.35,90.83,50.31,49.71,49.84,49.24,48.5,287,288,12,16,-1
"N.J","20182019",4984.4,82,219,271,-52,220.69,231.69,-10.99,2488,2594,-106,3390,3638,-248,4338,4796,-458,8.8,89.55,44.69,48.78,48.96,48.24,47.49,294,295,15,16,-1
"NSH","20072008",5056.37,82,227,224,3,206.86,193.56,13.3,2425,2439,-14,3310,3231,79,4257,4104,153,9.36,90.82,50.33,51.66,49.86,50.6,50.91,404,391,32,36,13
"NSH","20082009",4996.05,82,207,228,-21,197.98,216.32,-18.33,2375,2411,-36,3289,3317,-28,4275,4352,-77,8.72,90.54,47.59,47.79,49.62,49.79,49.55,354,375,40,40,-21
"NSH","20092010",4990.77,82,217,221,-4,207.27,203.61,3.67,2508,2396,112,3522,3259,263,4615,4265,350,8.65,90.78,49.54,50.45,51.14,51.94,51.97,318,285,23,22,33
"NSH","20102011",4994.22,82,213,190,23,207.69,203.39,4.29,2362,2508,-146,3202,3425,-223,4280,4432,-152,9.02,92.42,52.85,50.52,48.5,48.32,49.13,298,301,16,17,-3
"NSH","20112012",4982.73,82,232,205,27,195.51,207.06,-11.56,2261,2524,-263,3064,3497,-433,4026,4710,-684,10.26,91.88,53.09,48.57,47.25,46.7,46.09,274,266,20,17,8
"NSH","20122013",2929.38,48,109,133,-24,110.24,111.06,-0.81,1244,1335,-91,1708,1876,-168,2284,2579,-295,8.76,90.04,45.04,49.81,48.24,47.66,46.97,166,164,18,22,2
"NSH","20132014",4989.9,82,214,233,-19,196.56,186.81,9.75,2382,2370,12,3241,3326,-85,4240,4556,-316,8.98,90.17,47.87,51.27,50.13,49.35,48.2,278,272,32,31,6
"NSH","20142015",5010.12,82,226,202,24,213.13,192.69,20.44,2614,2318,296,3632,3205,427,4882,4385,497,8.65,91.29,52.8,52.52,53,53.12,52.68,299,275,16,17,24
"NSH","20152016",4980.22,82,224,213,11,217.28,186.49,30.79,2507,2243,264,3469,3039,430,4619,4271,348,8.93,90.5,51.26,53.81,52.78,53.3,51.96,304,286,26,29,18
"NSH","20162017",4985.75,82,238,220,18,221.72,209.77,11.95,2558,2473,85,3546,3461,85,4777,4571,206,9.3,91.1,51.97,51.38,50.84,50.61,51.1,296,282,40,40,14
"NSH","20172018",5006.68,82,261,204,57,233.67,232.08,1.59,2641,2660,-19,3700,3583,117,4926,4787,139,9.88,92.33,56.13,50.17,49.82,50.8,50.72,320,336,19,19,-16
"NSH","20182019",4967.4,82,236,212,24,235.84,228.35,7.49,2679,2460,219,3696,3408,288,4899,4487,412,8.81,91.38,52.68,50.81,52.13,52.03,52.19,284,287,17,16,-3
"NYI","20072008",4987.3,82,189,240,-51,201.71,230.67,-28.96,2434,2487,-53,3271,3452,-181,4427,4586,-159,7.76,90.35,44.06,46.65,49.46,48.65,49.12,381,427,28,26,-46
"NYI","20082009",4876.53,82,198,274,-76,201.07,252.73,-51.66,2373,2751,-378,3230,3825,-595,4419,5215,-796,8.34,90.04,41.95,44.31,46.31,45.78,45.87,364,401,42,47,-37
"NYI","20092010",4955.22,81,211,254,-43,229.9,237.39,-7.49,2471,2591,-120,3411,3594,-183,4583,4965,-382,8.54,90.2,45.38,49.2,48.81,48.69,48,350,348,33,34,2
"NYI","20102011",5013.12,82,225,258,-33,235.29,260.56,-25.26,2407,2620,-213,3308,3718,-410,4511,5105,-594,9.35,90.15,46.58,47.45,47.88,47.08,46.91,356,367,62,62,-11
"NYI","20112012",4999.63,82,196,251,-55,233.83,246.79,-12.96,2410,2466,-56,3260,3454,-194,4405,4818,-413,8.13,89.82,43.85,48.65,49.43,48.56,47.76,285,269,25,26,16
"NYI","20122013",2927.27,48,135,136,-1,150.57,130.76,19.81,1484,1352,132,2010,1925,85,2762,2691,71,9.1,89.94,49.82,53.52,52.33,51.08,50.65,177,169,16,15,8
"NYI","20132014",4915.98,82,216,261,-45,253.96,248.44,5.52,2537,2464,73,3468,3484,-16,4730,4726,4,8.51,89.41,45.28,50.55,50.73,49.88,50.02,332,323,35,38,9
"NYI","20142015",5007.9,82,245,224,21,284.21,227.43,56.79,2770,2321,449,3813,3221,592,5126,4543,583,8.84,90.35,52.24,55.55,54.41,54.21,53.01,310,261,13,13,49
"NYI","20152016",5005.05,82,227,211,16,234.99,236.17,-1.18,2411,2494,-83,3353,3406,-53,4603,4728,-125,9.42,91.54,51.83,49.87,49.15,49.61,49.33,275,280,22,22,-5
"NYI","20162017",4978.62,82,239,238,1,244.27,246.64,-2.36,2479,2616,-137,3396,3689,-293,4575,5052,-477,9.64,90.9,50.1,49.76,48.66,47.93,47.52,273,267,17,17,6
"NYI","20172018",4983.47,82,261,293,-32,235.69,263.27,-27.58,2573,2918,-345,3466,3948,-482,4692,5211,-519,10.14,89.96,47.11,47.24,46.86,46.75,47.38,265,263,16,15,2
"NYI","20182019",4983.17,82,223,191,32,236.49,226.89,9.61,2360,2535,-175,3229,3484,-255,4328,4779,-451,9.45,92.47,53.86,51.04,48.21,48.1,47.52,259,252,16,15,7
"NYR","20072008",5017.63,82,205,190,15,222.67,193.55,29.11,2577,2124,453,3574,2929,645,4596,3942,654,7.95,91.05,51.9,53.5,54.82,54.96,53.83,413,382,41,44,31
"NYR","20082009",5010.73,82,200,212,-12,252.58,242.92,9.67,2659,2433,226,3709,3384,325,4895,4341,554,7.52,91.29,48.54,50.97,52.22,52.29,53,408,389,48,50,19
"NYR","20092010",4977.13,82,219,214,5,248.79,251.88,-3.09,2425,2450,-25,3401,3443,-42,4525,4619,-94,9.03,91.27,50.58,49.69,49.74,49.69,49.49,359,375,48,49,-16
"NYR","20102011",4991.77,82,224,195,29,261.63,223.89,37.74,2453,2410,43,3393,3305,88,4472,4606,-134,9.13,91.91,53.46,53.89,50.44,50.66,49.26,343,309,61,59,34
"NYR","20112012",4998.05,82,222,182,40,249.76,223.5,26.26,2339,2281,58,3225,3227,-2,4247,4565,-318,9.49,92.02,54.95,52.77,50.63,49.98,48.2,330,313,59,61,17
"NYR","20122013",2927.25,48,126,108,18,139.15,131.94,7.21,1483,1353,130,2049,1903,146,2778,2676,102,8.5,92.02,53.85,51.33,52.29,51.85,50.94,168,162,18,16,6
"NYR","20132014",4766.88,82,214,190,24,238.46,216.45,22.01,2719,2412,307,3712,3312,400,4974,4431,543,7.87,92.12,52.97,52.42,52.99,52.85,52.89,334,296,23,23,38
"NYR","20142015",4983.07,82,248,187,61,239.46,220.95,18.51,2582,2418,164,3478,3410,68,4620,4569,51,9.6,92.27,57.01,52.01,51.64,50.49,50.28,270,272,20,20,-2
"NYR","20152016",4974.48,82,233,215,18,221.76,243.71,-21.95,2336,2494,-158,3272,3504,-232,4365,4818,-453,9.97,91.38,52.01,47.64,48.36,48.29,47.53,268,287,16,14,-19
"NYR","20162017",4974.23,82,253,216,37,244.04,228.12,15.91,2438,2465,-27,3438,3441,-3,4512,4685,-173,10.38,91.24,53.94,51.69,49.72,49.98,49.06,269,254,16,14,15
"NYR","20172018",4979.5,82,228,263,-35,244.26,266.2,-21.94,2537,2899,-362,3456,3906,-450,4523,5134,-611,8.99,90.93,46.44,47.85,46.67,46.94,46.84,265,275,18,16,-10
"NYR","20182019",4902.67,82,221,267,-46,225.73,260,-34.27,2393,2774,-381,3248,3816,-568,4272,5029,-757,9.24,90.37,45.29,46.47,46.31,45.98,45.93,269,300,23,24,-31
"OTT","20072008",4978.62,82,258,242,16,217.49,212.67,4.82,2471,2456,15,3406,3333,73,4561,4344,217,10.44,90.15,51.6,50.56,50.15,50.54,51.22,393,448,25,27,-55
"OTT","20082009",4993.48,82,213,231,-18,197.02,193.2,3.82,2406,2337,69,3259,3212,47,4324,4359,-35,8.85,90.12,47.97,50.49,50.73,50.36,49.8,394,406,22,19,-12
"OTT","20092010",4986.47,82,220,233,-13,211.29,204.63,6.66,2436,2339,97,3345,3221,124,4481,4414,67,9.03,90.04,48.57,50.8,51.02,50.94,50.38,344,370,36,36,-26
"OTT","20102011",4972.03,82,190,245,-55,197.56,227.52,-29.96,2381,2559,-178,3273,3511,-238,4380,4626,-246,7.98,90.43,43.68,46.48,48.2,48.25,48.63,319,347,36,40,-28
"OTT","20112012",4935.28,81,241,233,8,218.51,225.57,-7.06,2540,2601,-61,3559,3522,37,4890,4586,304,9.49,91.04,50.84,49.21,49.41,50.26,51.6,310,351,42,42,-41
"OTT","20122013",2930.63,48,112,100,12,128.17,117.16,11.01,1591,1502,89,2189,2026,163,3008,2642,366,7.04,93.34,52.83,52.24,51.44,51.93,53.24,188,199,14,13,-11
"OTT","20132014",5008.7,82,229,258,-29,216.72,242.92,-26.2,2692,2850,-158,3784,3832,-48,5032,4787,245,8.51,90.95,47.02,47.15,48.57,49.68,51.25,338,385,28,29,-47
"OTT","20142015",5026.4,82,232,208,24,233.23,216.27,16.96,2540,2635,-95,3513,3570,-57,4813,4615,198,9.13,92.11,52.73,51.89,49.08,49.6,51.05,323,304,28,30,19
"OTT","20152016",5003.58,82,230,241,-11,206.6,237.35,-30.74,2325,2688,-363,3252,3673,-421,4475,4869,-394,9.89,91.03,48.83,46.54,46.38,46.96,47.89,286,301,33,33,-15
"OTT","20162017",4993.95,82,206,210,-4,208.99,209.85,-0.86,2464,2467,-3,3380,3513,-133,4592,4865,-273,8.36,91.49,49.52,49.9,49.97,49.04,48.56,323,314,30,33,9
"OTT","20172018",4985.07,82,219,284,-65,202.3,242.67,-40.36,2515,2712,-197,3464,3751,-287,4676,5088,-412,8.71,89.53,43.54,45.46,48.12,48.01,47.89,276,269,15,16,7
"OTT","20182019",4944.65,82,241,301,-60,217.34,245.89,-28.55,2428,2930,-502,3311,4003,-692,4376,5384,-1008,9.93,89.73,44.46,46.92,45.32,45.27,44.84,262,253,22,22,9
"PHI","20072008",4985.3,82,245,227,18,199.31,202.69,-3.39,2358,2608,-250,3235,3525,-290,4267,4697,-430,10.39,91.3,51.91,49.58,47.48,47.86,47.6,470,471,61,58,-1
"PHI","20082009",5004.82,82,260,232,28,212.86,234.03,-21.16,2441,2668,-227,3363,3708,-345,4506,4951,-445,10.65,91.3,52.85,47.63,47.78,47.56,47.65,386,460,59,61,-74
"PHI","20092010",4969.33,82,232,222,10,244.46,211.72,32.74,2589,2348,241,3590,3271,319,4789,4525,264,8.96,90.55,51.1,53.59,52.44,52.32,51.42,400,411,72,74,-11
"PHI","20102011",4988.27,82,256,216,40,242.82,220.54,22.28,2605,2471,134,3556,3486,70,4764,4803,-39,9.83,91.26,54.24,52.4,51.32,50.5,49.8,335,358,46,44,-23
"PHI","20112012",5001.97,82,260,225,35,259.54,215.54,43.99,2640,2329,311,3642,3303,339,4883,4511,372,9.85,90.34,53.61,54.63,53.13,52.44,51.98,416,401,50,54,15
"PHI","20122013",2900.9,48,132,139,-7,124.54,126.18,-1.64,1395,1371,24,1916,1976,-60,2600,2760,-160,9.46,89.86,48.71,49.67,50.43,49.23,48.51,207,225,31,32,-18
"PHI","20132014",4991.68,82,233,227,6,220.21,213.47,6.74,2490,2508,-18,3495,3422,73,4776,4622,154,9.36,90.95,50.65,50.78,49.82,50.53,50.82,333,364,41,41,-31
"PHI","20142015",4921.38,82,212,223,-11,210.25,225.33,-15.08,2413,2481,-68,3353,3444,-91,4628,4692,-64,8.79,91.01,48.74,48.27,49.31,49.33,49.66,286,299,30,28,-13
"PHI","20152016",5012.58,82,211,210,1,231.14,226.97,4.17,2542,2519,23,3555,3407,148,4903,4716,187,8.3,91.66,50.12,50.46,50.23,51.06,50.97,343,321,25,28,22
"PHI","20162017",5007.7,82,212,231,-19,230.25,213.76,16.49,2584,2334,250,3635,3244,391,4961,4553,408,8.2,90.1,47.86,51.86,52.54,52.84,52.14,326,297,26,29,29
"PHI","20172018",4996.85,82,249,236,13,244.13,218.02,26.11,2632,2448,184,3597,3437,160,4779,4667,112,9.46,90.36,51.34,52.82,51.81,51.14,50.59,306,261,19,18,45
"PHI","20182019",4963.82,82,241,280,-39,235.99,236.74,-0.75,2583,2665,-82,3552,3580,-28,4740,4857,-117,9.33,89.49,46.26,49.92,49.22,49.8,49.39,284,280,11,11,4
"PIT","20072008",4985.53,82,240,212,28,208.94,194.32,14.62,2269,2523,-254,3165,3554,-389,4064,4682,-618,10.58,91.6,53.1,51.81,47.35,47.11,46.47,428,399,43,48,29
"PIT","20082009",4909.82,82,258,233,25,217.33,206.91,10.42,2381,2484,-103,3304,3442,-138,4376,4722,-346,10.84,90.62,52.55,51.23,48.94,48.98,48.1,418,404,39,36,14
"PIT","20092010",4932.93,81,247,233,14,226.06,203.54,22.52,2651,2321,330,3692,3295,397,4864,4463,401,9.32,89.96,51.46,52.62,53.32,52.84,52.15,389,397,50,47,-8
"PIT","20102011",5016.07,82,228,196,32,208.96,200.87,8.09,2582,2351,231,3553,3226,327,4841,4308,533,8.83,91.66,53.77,50.99,52.34,52.41,52.91,380,391,68,67,-11
"PIT","20112012",4995.57,82,273,218,55,246.78,201.82,44.96,2779,2246,533,3867,3119,748,5162,4184,978,9.82,90.29,55.6,55.01,55.3,55.35,55.23,351,337,30,28,14
"PIT","20122013",2898.42,48,162,119,43,134.3,120,14.3,1438,1403,35,1985,1950,35,2635,2685,-50,11.27,91.52,57.65,52.81,50.62,50.44,49.53,202,199,20,21,3
"PIT","20132014",4886.9,82,242,204,38,209.52,196.63,12.9,2454,2359,95,3319,3342,-23,4402,4529,-127,9.86,91.35,54.26,51.59,50.99,49.83,49.29,335,305,24,26,30
"PIT","20142015",5001.57,82,217,204,13,222.69,209.65,13.05,2594,2401,193,3511,3240,271,4676,4333,343,8.37,91.5,51.54,51.51,51.93,52.01,51.9,340,365,29,30,-25
"PIT","20152016",4984.73,82,241,199,42,248.16,199.42,48.73,2722,2436,286,3638,3298,340,4831,4389,442,8.85,91.83,54.77,55.44,52.77,52.45,52.4,312,319,11,8,-7
"PIT","20162017",4989.83,82,278,229,49,264.37,244.1,20.26,2751,2671,80,3652,3549,103,4818,4856,-38,10.11,91.43,54.83,51.99,50.74,50.72,49.8,309,302,13,12,7
"PIT","20172018",4966.32,82,270,248,22,256.51,236.5,20,2823,2553,270,3795,3446,349,4965,4630,335,9.56,90.29,52.12,52.03,52.51,52.41,51.75,300,311,15,15,-11
"PIT","20182019",4981.5,82,271,238,33,248.94,230.67,18.27,2731,2729,2,3643,3673,-30,4795,4902,-107,9.92,91.28,53.24,51.9,50.02,49.79,49.45,266,257,13,13,9
"S.J","20072008",4966.3,82,216,187,29,222.16,168.82,53.34,2428,1981,447,3356,2768,588,4314,3759,555,8.9,90.56,53.6,56.82,55.07,54.8,53.44,439,374,37,34,65
"S.J","20082009",4899.87,82,251,199,52,250.67,189.82,60.85,2720,2228,492,3731,3044,687,4892,4012,880,9.23,91.07,55.78,56.91,54.97,55.07,54.94,423,363,40,41,60
"S.J","20092010",4938.42,81,257,206,51,240.58,221.59,18.99,2563,2549,14,3603,3540,63,4797,4595,202,10.03,91.92,55.51,52.05,50.14,50.44,51.08,359,378,55,53,-19
"S.J","20102011",4998.78,82,243,208,35,268.66,202.22,66.45,2831,2369,462,3926,3279,647,5249,4420,829,8.58,91.22,53.88,57.05,54.44,54.49,54.29,325,308,43,43,17
"S.J","20112012",5017.95,82,219,205,14,243.81,197.96,45.85,2773,2343,430,3854,3261,593,5162,4588,574,7.9,91.25,51.65,55.19,54.2,54.17,52.94,304,265,32,32,39
"S.J","20122013",2948.32,48,116,112,4,139.51,121.1,18.42,1526,1390,136,2159,1960,199,2962,2760,202,7.6,91.94,50.88,53.53,52.33,52.42,51.77,192,168,11,11,24
"S.J","20132014",5021.05,82,239,193,46,269.32,187.94,81.38,2851,2282,569,3999,3206,793,5379,4492,887,8.38,91.54,55.32,58.9,55.54,55.5,54.49,322,255,24,26,67
"S.J","20142015",4881.58,82,224,226,-2,243.05,220.33,22.73,2592,2436,156,3691,3421,270,5097,4713,384,8.64,90.72,49.78,52.45,51.55,51.9,51.96,306,274,22,22,32
"S.J","20152016",4875.9,82,237,207,30,244.22,201.94,42.28,2491,2245,246,3506,3115,391,4722,4407,315,9.51,90.78,53.38,54.74,52.6,52.95,51.73,299,268,31,31,31
"S.J","20162017",4955.93,82,219,200,19,230.99,212.22,18.77,2456,2268,188,3543,3265,278,4888,4624,264,8.92,91.18,52.27,52.12,51.99,52.04,51.39,280,235,23,22,45
"S.J","20172018",4985.38,82,247,226,21,255.77,228.52,27.25,2702,2489,213,3799,3474,325,5169,4855,314,9.14,90.92,52.22,52.81,52.05,52.23,51.57,284,247,11,13,37
"S.J","20182019",4962.17,82,289,258,31,257.56,229.82,27.75,2708,2324,384,3815,3237,578,5144,4314,830,10.67,88.9,52.83,52.85,53.82,54.1,54.39,280,273,12,12,7
"STL","20072008",4979.07,82,202,232,-30,174.43,206.88,-32.45,2140,2249,-109,2960,3245,-285,3760,4285,-525,9.44,89.68,46.54,45.74,48.76,47.7,46.74,392,417,42,42,-25
"STL","20082009",4994.82,82,227,227,0,203,199.41,3.59,2271,2342,-71,3235,3349,-114,4151,4477,-326,10,90.31,50,50.45,49.23,49.13,48.11,404,406,52,50,-2
"STL","20092010",5002.07,82,218,218,0,211.69,218.36,-6.67,2444,2474,-30,3433,3462,-29,4530,4517,13,8.92,91.19,50,49.22,49.69,49.79,50.07,361,403,67,64,-42
"STL","20102011",4987.78,82,236,228,8,214.6,210.51,4.09,2475,2275,200,3518,3188,330,4675,4287,388,9.54,89.98,50.86,50.48,52.11,52.46,52.16,332,334,71,72,-2
"STL","20112012",4942.15,81,202,154,48,230.7,187.53,43.17,2481,2155,326,3535,3027,508,4670,4128,542,8.14,92.85,56.74,55.16,53.52,53.87,53.08,331,346,40,41,-15
"STL","20122013",2919.8,48,124,114,10,108.15,108,0.15,1336,1161,175,1875,1651,224,2526,2328,198,9.28,90.18,52.1,50.03,53.5,53.18,52.04,185,189,18,18,-4
"STL","20132014",5002.03,82,239,188,51,208.33,186.94,21.39,2403,2163,240,3429,3034,395,4621,4155,466,9.95,91.31,55.97,52.71,52.63,53.06,52.65,353,361,30,31,-8
"STL","20142015",5003.42,82,239,197,42,221.88,190.42,31.46,2536,2233,303,3529,3122,407,4621,4295,326,9.42,91.18,54.82,53.82,53.18,53.06,51.83,315,326,28,29,-11
"STL","20152016",5005.07,82,219,197,22,211.15,219.76,-8.61,2473,2441,32,3391,3330,61,4494,4457,37,8.86,91.93,52.64,49,50.33,50.45,50.21,286,324,24,23,-38
"STL","20162017",4964.65,82,233,216,17,205.07,205.79,-0.72,2330,2327,3,3207,3229,-22,4276,4364,-88,10,90.72,51.89,49.91,50.03,49.83,49.49,270,302,15,15,-32
"STL","20172018",4966.93,82,223,222,1,221.35,212.93,8.41,2677,2438,239,3664,3295,369,4905,4572,333,8.33,90.89,50.11,50.97,52.34,52.65,51.76,279,262,13,14,17
"STL","20182019",4980.98,82,244,220,24,243.32,214.07,29.25,2604,2345,259,3531,3247,284,4693,4385,308,9.37,90.62,52.59,53.2,52.62,52.1,51.7,263,264,14,15,-1
"T.B","20072008",4963.28,82,221,266,-45,188.71,190.75,-2.04,2354,2312,42,3228,3199,29,4230,4271,-41,9.39,88.49,45.38,49.73,50.45,50.23,49.76,335,348,31,34,-13
"T.B","20082009",5008.2,82,207,269,-62,195.25,221.03,-25.78,2338,2702,-364,3190,3643,-453,4137,4747,-610,8.85,90.04,43.49,46.9,46.39,46.69,46.57,386,450,48,48,-64
"T.B","20092010",5002,82,213,253,-40,197.86,223.68,-25.82,2367,2575,-208,3259,3514,-255,4237,4622,-385,9,90.17,45.71,46.94,47.9,48.12,47.83,399,404,68,66,-5
"T.B","20102011",5013.22,82,241,234,7,229.54,189.27,40.27,2606,2354,252,3595,3292,303,4738,4541,197,9.25,90.06,50.74,54.81,52.54,52.2,51.06,388,351,21,22,37
"T.B","20112012",4990.97,82,232,278,-46,187.97,225.69,-37.72,2227,2501,-274,3086,3515,-429,4167,4793,-626,10.42,88.88,45.49,45.44,47.1,46.75,46.51,316,330,21,21,-14
"T.B","20122013",2904.3,48,147,147,0,114.37,130.7,-16.32,1323,1450,-127,1826,2056,-230,2410,2736,-326,11.11,89.86,50,46.67,47.71,47.04,46.83,193,185,27,27,8
"T.B","20132014",5013.12,82,232,209,23,206.25,210.02,-3.77,2447,2399,48,3443,3406,37,4478,4527,-49,9.48,91.29,52.61,49.55,50.5,50.27,49.73,310,307,28,28,3
"T.B","20142015",4977.03,82,259,206,53,214.06,194.3,19.76,2428,2287,141,3356,3185,171,4507,4283,224,10.67,90.99,55.7,52.42,51.5,51.31,51.27,343,314,23,23,29
"T.B","20152016",4966.73,82,224,198,26,199.43,198.07,1.35,2403,2367,36,3397,3322,75,4551,4349,202,9.32,91.63,53.08,50.17,50.38,50.56,51.13,333,313,21,21,20
"T.B","20162017",4988.13,82,230,224,6,214.63,207.98,6.65,2454,2492,-38,3470,3401,69,4605,4415,190,9.37,91.01,50.66,50.79,49.62,50.5,51.05,314,314,34,34,0
"T.B","20172018",4979.6,82,290,234,56,239.06,215.9,23.16,2680,2683,-3,3766,3584,182,4984,4711,273,10.82,91.28,55.34,52.55,49.97,51.24,51.41,318,315,18,17,3
"T.B","20182019",4979.57,82,319,221,98,242.21,219.44,22.77,2621,2633,-12,3604,3542,62,4725,4667,58,12.17,91.61,59.07,52.47,49.89,50.43,50.31,307,312,12,12,-5
"TOR","20072008",4990.87,82,228,256,-28,209.92,218.39,-8.46,2542,2403,139,3557,3393,164,4669,4457,212,8.97,89.35,47.11,49.01,51.41,51.18,51.16,395,411,24,22,-16
"TOR","20082009",4945.9,81,242,283,-41,219.31,223.74,-4.42,2573,2458,115,3639,3552,87,4850,4791,59,9.41,88.49,46.1,49.5,51.14,50.6,50.31,380,361,42,43,19
"TOR","20092010",5003.18,82,210,263,-53,221.22,219.61,1.61,2671,2440,231,3788,3479,309,5171,4697,474,7.86,89.22,44.4,50.18,52.26,52.13,52.4,372,345,52,50,27
"TOR","20102011",4994.67,82,213,245,-32,195.98,218.75,-22.77,2360,2540,-180,3367,3630,-263,4720,4953,-233,9.03,90.35,46.51,47.25,48.16,48.12,48.8,363,316,47,48,47
"TOR","20112012",4986.67,82,227,259,-32,209.51,229.83,-20.31,2322,2528,-206,3313,3598,-285,4616,4821,-205,9.78,89.75,46.71,47.69,47.88,47.94,48.91,308,287,31,29,21
"TOR","20122013",2911.15,48,145,128,17,110.14,129.59,-19.45,1264,1549,-285,1811,2213,-402,2489,3039,-550,11.47,91.74,53.11,45.94,44.93,45,45.03,193,182,39,39,11
"TOR","20132014",4907.25,82,222,252,-30,200.81,259.58,-58.77,2291,2944,-653,3156,4229,-1073,4264,5506,-1242,9.69,91.44,46.84,43.62,43.76,42.74,43.64,300,317,44,44,-17
"TOR","20142015",4989.98,82,206,257,-51,204.67,258.87,-54.2,2397,2748,-351,3335,3863,-528,4422,5038,-616,8.59,90.65,44.49,44.15,46.59,46.33,46.74,335,313,23,23,22
"TOR","20152016",4996.53,82,192,240,-48,237.09,219.21,17.89,2515,2503,12,3703,3523,180,5036,4558,478,7.63,90.41,44.44,51.96,50.12,51.25,52.49,319,330,9,10,-11
"TOR","20162017",4991.68,82,250,234,16,265.06,256.04,9.03,2617,2673,-56,3758,3802,-44,4989,4968,21,9.55,91.25,51.65,50.87,49.47,49.71,50.11,296,299,26,26,-3
"TOR","20172018",4988.08,82,270,230,40,262,243.41,18.59,2642,2776,-134,3713,3862,-149,5002,4966,36,10.22,91.71,54,51.84,48.76,49.02,50.18,251,255,11,10,-4
"TOR","20182019",4958.17,82,286,249,37,275.02,240.67,34.35,2737,2718,19,3975,3847,128,5387,4960,427,10.45,90.84,53.46,53.33,50.17,50.82,52.06,231,223,7,7,8
"VAN","20072008",5006.47,82,207,206,1,190.52,190.28,0.24,2251,2365,-114,3139,3313,-174,4035,4301,-266,9.2,91.29,50.12,50.03,48.77,48.65,48.4,442,442,64,58,0
"VAN","20082009",4830.18,81,242,208,34,212.23,199.64,12.59,2299,2360,-61,3236,3304,-68,4276,4290,-14,10.53,91.19,53.78,51.53,49.35,49.48,49.92,423,431,58,58,-8
"VAN","20092010",4772.82,82,268,218,50,220.4,200.24,20.17,2534,2419,115,3565,3329,236,4672,4319,353,10.58,90.99,55.14,52.4,51.16,51.71,51.96,398,387,60,57,11
"VAN","20102011",4984.9,82,257,180,77,226.19,218.29,7.9,2623,2470,153,3645,3364,281,4900,4435,465,9.8,92.71,58.81,50.89,51.5,52,52.49,339,354,27,26,-15
"VAN","20112012",5021.92,82,241,191,50,212.73,224.5,-11.76,2583,2526,57,3573,3299,274,4875,4318,557,9.33,92.44,55.79,48.65,50.56,51.99,53.03,334,331,35,35,3
"VAN","20122013",2943.72,48,122,115,7,118.99,119.33,-0.34,1351,1389,-38,1914,1866,48,2624,2433,191,9.03,91.72,51.48,49.93,49.31,50.63,51.89,196,195,23,23,1
"VAN","20132014",5007.85,82,191,216,-25,213.15,215.91,-2.76,2526,2328,198,3557,3274,283,4806,4491,315,7.56,90.72,46.93,49.68,52.04,52.07,51.69,305,324,35,36,-19
"VAN","20142015",4979.82,82,236,220,16,213.22,227.32,-14.1,2454,2446,8,3354,3376,-22,4429,4592,-163,9.62,91.01,51.75,48.4,50.08,49.84,49.1,292,325,29,28,-33
"VAN","20152016",5004.35,82,186,239,-53,199.88,247.55,-47.67,2311,2667,-356,3169,3606,-437,4218,4664,-446,8.05,91.04,43.76,44.67,46.42,46.77,47.49,294,299,23,23,-5
"VAN","20162017",4979.55,82,178,241,-63,192.71,242.82,-50.11,2273,2608,-335,3116,3528,-412,4240,4562,-322,7.83,90.76,42.48,44.25,46.57,46.9,48.17,244,239,18,18,5
"VAN","20172018",4972.98,82,218,259,-41,208.76,239.16,-30.4,2463,2644,-181,3368,3649,-281,4470,4801,-331,8.85,90.2,45.7,46.61,48.23,48,48.21,257,288,11,10,-31
"VAN","20182019",5009.97,82,219,248,-29,204.28,239.6,-35.32,2433,2597,-164,3395,3585,-190,4526,4818,-292,9,90.45,46.9,46.02,48.37,48.64,48.44,277,277,8,9,0
"VGK","20172018",4985.68,82,268,225,43,245.23,219.03,26.2,2687,2523,164,3734,3512,222,5020,4691,329,9.97,91.08,54.36,52.82,51.57,51.53,51.69,274,261,8,8,13
"VGK","20182019",4859.52,82,246,228,18,264.32,218.45,45.87,2815,2400,415,3884,3244,640,5254,4361,893,8.74,90.5,51.9,54.75,53.98,54.49,54.64,256,254,6,6,2
"WPG","20112012",4985.48,82,221,242,-21,226,237.33,-11.32,2471,2470,1,3538,3492,46,4638,4689,-51,8.94,90.2,47.73,48.78,50.01,50.33,49.73,293,331,33,33,-38
"WPG","20122013",2917.42,48,126,141,-15,128.4,129.88,-1.48,1390,1424,-34,1998,2007,-9,2741,2720,21,9.06,90.1,47.19,49.71,49.4,49.89,50.19,167,161,25,25,6
"WPG","20132014",5013.05,82,219,231,-12,233.62,229.68,3.94,2516,2473,43,3543,3458,85,4762,4714,48,8.7,90.66,48.67,50.43,50.43,50.61,50.25,319,345,32,33,-26
"WPG","20142015",5009.77,82,223,204,19,230.91,225.68,5.23,2439,2350,89,3401,3240,161,4689,4360,329,9.14,91.32,52.22,50.57,50.93,51.21,51.82,338,381,30,31,-43
"WPG","20152016",4971.38,82,212,236,-24,218.69,234.69,-15.99,2429,2422,7,3366,3330,36,4558,4463,95,8.73,90.26,47.32,48.24,50.07,50.27,50.53,313,341,29,29,-28
"WPG","20162017",4964.83,82,246,255,-9,228.98,219.88,9.1,2448,2548,-100,3361,3444,-83,4432,4621,-189,10.05,89.99,49.1,51.01,49,49.39,48.96,304,323,26,28,-19
"WPG","20172018",4982.18,82,273,216,57,234.84,220.12,14.71,2643,2613,30,3649,3621,28,4839,4859,-20,10.33,91.73,55.83,51.62,50.29,50.19,49.9,301,305,7,8,-4
"WPG","20182019",4966.67,82,270,243,27,228.87,242.21,-13.34,2558,2741,-183,3530,3720,-190,4664,4907,-243,10.56,91.13,52.63,48.58,48.27,48.69,48.73,284,282,16,17,2
"WSH","20072008",4986.92,82,238,227,11,209.71,192.69,17.02,2538,2258,280,3545,3074,471,4727,4079,648,9.38,89.95,51.18,52.11,52.92,53.56,53.68,378,384,29,26,-6
"WSH","20082009",4885.65,82,268,240,28,245.81,212.81,33,2748,2418,330,3807,3329,478,5145,4440,705,9.75,90.07,52.76,53.6,53.19,53.35,53.68,378,428,26,27,-50
"WSH","20092010",5008.63,82,313,227,86,253.31,218.74,34.56,2693,2535,158,3766,3517,249,5197,4670,527,11.62,91.05,57.96,53.66,51.51,51.71,52.67,342,348,16,18,-6
"WSH","20102011",5010.6,82,219,191,28,228.36,201.23,27.13,2566,2375,191,3557,3318,239,4870,4575,295,8.53,91.96,53.41,53.16,51.93,51.74,51.56,291,329,40,39,-38
"WSH","20112012",4985.82,82,218,226,-8,191.66,206.36,-14.7,2296,2475,-179,3230,3437,-207,4381,4739,-358,9.49,90.87,49.1,48.15,48.12,48.45,48.04,278,296,25,26,-18
"WSH","20122013",2909.52,48,146,130,16,122.52,129.95,-7.43,1350,1551,-201,1903,2060,-157,2610,2825,-215,10.81,91.62,52.9,48.53,46.54,48.02,48.02,183,189,17,15,-6
"WSH","20132014",5037.1,82,225,229,-4,214.88,233.24,-18.36,2412,2751,-339,3364,3764,-400,4521,4975,-454,9.33,91.68,49.56,47.95,46.72,47.19,47.61,329,325,35,35,4
"WSH","20142015",5001.93,82,237,199,38,217.38,203.91,13.47,2420,2368,52,3480,3330,150,4735,4601,134,9.79,91.6,54.36,51.6,50.54,51.1,50.72,299,326,26,26,-27
"WSH","20152016",4982.7,82,248,191,57,231.81,209.22,22.6,2510,2333,177,3496,3326,170,4702,4592,110,9.88,91.81,56.49,52.56,51.83,51.25,50.59,301,293,19,21,8
"WSH","20162017",4973.15,82,261,177,84,224.41,216.15,8.26,2495,2282,213,3487,3275,212,4678,4377,301,10.46,92.24,59.59,50.94,52.23,51.57,51.66,290,319,14,16,-29
"WSH","20172018",4975.1,82,256,238,18,221.12,252.51,-31.39,2378,2613,-235,3382,3761,-379,4547,4981,-434,10.77,90.89,51.82,46.69,47.65,47.35,47.72,275,305,22,19,-30
"WSH","20182019",4977.83,82,274,248,26,235.73,248.88,-13.15,2493,2585,-92,3567,3643,-76,4706,4877,-171,10.99,90.41,52.49,48.64,49.09,49.47,49.11,263,298,15,15,-35
